AP	Ampco-Pittsburgh Corporation
BICEY	Société BIC S.A.
XELA	Exela Technologies, Inc.
FSR	Fisker Inc.
IRIX	IRIDEX Corporation
IMPP	Imperial Petroleum Inc.
CX	CEMEX, S.A.B. de C.V.
BODI	The Beachbody Company, Inc.
XPO	XPO Logistics, Inc.
STLJF	Stella-Jones Inc.
HXL	Hexcel Corporation
AEE	Ameren Corporation
RGP	Resources Connection, Inc.
EGHSF	Enghouse Systems Limited
STER	Sterling Check Corp.
INFY	Infosys Limited
SHSP	SharpSpring, Inc.
LOMA	Loma Negra Compañía Industrial Argentina Sociedad Anónima
HNI	HNI Corporation
METC	Ramaco Resources, Inc.
AUKNY	Auckland International Airport Limited
AFGVF	Agfa-Gevaert N.V.
TRX	TRX Gold Corporation
TNK	Teekay Tankers Ltd.
LPTX	Leap Therapeutics, Inc.
SDMHF	Sartorius Stedim Biotech S.A.
BIG	Big Lots, Inc.
MNST	Monster Beverage Corporation
CCEC	Capital Clean Energy Carriers Corp.
CF	CF Industries Holdings, Inc.
DGWPF	Drägerwerk AG & Co. KGaA
DKNG	DraftKings Inc.
HAE	Haemonetics Corporation
SWDAF	Software AG
CUE	Cue Biopharma, Inc.
ATSG	Air Transport Services Group, Inc.
RENN	Renren Inc.
VKTX	Viking Therapeutics, Inc.
SGBX	Safe & Green Holdings Corp.
LCTX	Lineage Cell Therapeutics, Inc.
TBRG	TruBridge, Inc.
TPIC	TPI Composites, Inc.
DOLE	Dole plc
LRCDF	Laurentian Bank of Canada
MDRX	Veradigm Inc.
TGNA	TEGNA Inc.
PCG	PG&E Corporation
CNFR	Conifer Holdings, Inc.
CUZ	Cousins Properties Incorporated
CACC	Credit Acceptance Corporation
TTMI	TTM Technologies, Inc.
LNVGY	Lenovo Group Limited
UVE	Universal Insurance Holdings, Inc.
ATI	ATI Inc.
ARCB	ArcBest Corporation
TIXT	TELUS International (Cda) Inc.
AREC	American Resources Corporation
PRTA	Prothena Corporation plc
PHPPY	Signify N.V.
POST	Post Holdings, Inc.
GB	Global Blue Group Holding AG
KRUS	Kura Sushi USA, Inc.
TACO	Berto Acquisition Corp.
PEGRF	Pennon Group Plc
DOV	Dover Corporation
YMM	Full Truck Alliance Co. Ltd.
FLGC	Flora Growth Corp.
UNRV	Unrivaled Brands, Inc.
AMP	Ameriprise Financial, Inc.
LBRT	Liberty Energy Inc.
ROK	Rockwell Automation, Inc.
MIXT	MiX Telematics Limited
DGICB	Donegal Group Inc.
MCBC	Macatawa Bank Corporation
VNRX	VolitionRx Limited
REKR	Rekor Systems, Inc.
OMAB	Grupo Aeroportuario del Centro Norte, S.A.B. de C.V.
SLQT	SelectQuote, Inc.
SLHG	Skylight Health Group Inc.
PRFT	Perficient, Inc.
MPWR	Monolithic Power Systems, Inc.
ALPMF	Astellas Pharma Inc.
GGAL	Grupo Financiero Galicia S.A.
LYG	Lloyds Banking Group plc
NXPRF	Nexans S.A.
KURA	Kura Oncology, Inc.
PEBO	Peoples Bancorp Inc.
APEMY	Aperam S.A.
BOXD	Boxed, Inc.
AZEK	The AZEK Company Inc.
RYDAF	Shell plc
DLHC	DLH Holdings Corp.
KWR	Quaker Chemical Corporation
RH	Rh
MBRX	Moleculin Biotech, Inc.
SNDX	Syndax Pharmaceuticals, Inc.
RBCN	Rubicon Technology, Inc.
PRAA	PRA Group, Inc.
IHRT	iHeartMedia, Inc.
SDXOF	Sodexo S.A.
THRN	Thorne HealthTech, Inc.
JG	Aurora Mobile Limited
LUCK	Lucky Strike Entertainment Corporation
CLRO	ClearOne, Inc.
NYXH	Nyxoah S.A.
GENE	Genetic Technologies Limited
APTV	Aptiv PLC
UFPI	UFP Industries, Inc.
ELVT	Elevate Credit, Inc.
ALUR	Allurion Technologies Inc.
GDOT	Green Dot Corporation
VNTRF	Venator Materials PLC
LOWLF	Lowell Farms Inc.
FNF	Fidelity National Financial, Inc.
PHX	PHX Minerals Inc.
SCND	Scientific Industries, Inc.
GDNSF	Goodness Growth Holdings, Inc.
CMPO	CompoSecure, Inc.
DLTNF	Delta 9 Cannabis Inc.
MRIN	Marin Software Incorporated
KEYUF	Keyera Corp.
WPM	Wheaton Precious Metals Corp.
ESALY	Eisai Co., Ltd.
ZM	Zoom Video Communications, Inc.
FALC	FalconStor Software, Inc.
DOCU	DocuSign, Inc.
CIG	Companhia Energética de Minas Gerais
RUSHA	Rush Enterprises, Inc.
ALEX	Alexander & Baldwin, Inc.
NOK	Nokia Oyj
SYY	Sysco Corporation
CNET	ZW Data Action Technologies Inc.
FQVTF	Fevertree Drinks PLC
KIM	Kimco Realty Corporation
SGMO	Sangamo Therapeutics, Inc.
OCC	Optical Cable Corporation
ATAI	Atai Life Sciences N.V.
BMMJ	Body and Mind Inc.
MTH	Meritage Homes Corporation
RGA	Reinsurance Group of America, Incorporated
BDN	Brandywine Realty Trust
TRQ	Turquoise Hill Resources Ltd.
SNCY	Sun Country Airlines Holdings, Inc.
IFCZF	Intact Financial Corporation
ONXXF	Ontex Group N.V.
PALT	Paltalk, Inc.
SMTS	Sierra Metals Inc.
POOL	Pool Corporation
EPC	Edgewell Personal Care Company
QH	Quhuo Limited
HUN	Huntsman Corporation
CLQDF	Cliq Digital AG
NWHM	The New Home Company Inc.
AMZN	Amazon.com, Inc.
FSCO	FS Credit Opportunities Corp.
TRS	TriMas Corporation
SO	The Southern Company
APPF	AppFolio, Inc.
SIMO	Silicon Motion Technology Corporation
BIRDF	Bird Construction Inc.
LMND	Lemonade, Inc.
TPH	Tri Pointe Homes, Inc.
HDB	HDFC Bank Limited
APDN	Applied DNA Sciences, Inc.
LRFC	Logan Ridge Finance Corporation
REFR	Research Frontiers Incorporated
LC	LendingClub Corporation
FERG	Ferguson plc
ACCD	Accolade, Inc.
STZ	Constellation Brands, Inc.
NET	Cloudflare, Inc.
ENCVF	Encavis AG
HAYN	Haynes International, Inc.
FLNT	Fluent, Inc.
DPZ	Domino's Pizza, Inc.
TIPT	Tiptree Inc.
603259.SS	WuXi AppTec Co., Ltd.
QRTEA	Qurate Retail, Inc.
ADT	ADT Inc.
BHAT	Fujian Blue Hat Interactive Entertainment Technology Ltd.
KNSL	Kinsale Capital Group, Inc.
ZENV	Zenvia Inc.
MICT	MICT, Inc.
GRRMF	Gerresheimer AG
EBKOF	Erste Group Bank AG
PHMMF	Pharma Mar, S.A.
SPSC	SPS Commerce, Inc.
CYBR	CyberArk Software Ltd.
TLGPY	Telstra Group Limited
TTNMF	Titanium Transportation Group Inc.
AAMI	Acadian Asset Management
NWPX	Northwest Pipe Company
LSEA	Landsea Homes Corporation
HUIZ	Huize Holding Limited
OSK	Oshkosh Corporation
ACDVF	Air Canada
LUNA	Luna Innovations Incorporated
BFST	Business First Bancshares, Inc.
LAZR	Luminar Technologies, Inc.
SMSOF	Samsonite International S.A.
MKFG	Markforged Holding Corporation
OPCH	Option Care Health, Inc.
AONC	American Oncology Network, Inc.
CMAX	CareMax, Inc.
UI	Ubiquiti Inc.
MNSO	MINISO Group Holding Limited
IRS	IRSA Inversiones y Representaciones Sociedad Anónima
GWRS	Global Water Resources, Inc.
ING	ING Groep N.V.
CNH	CNH Industrial N.V.
BURL	Burlington Stores, Inc.
WJXFF	Wajax Corporation
ONIT	Onity Group Inc.
ICLK	iClick Interactive Asia Group Limited
TGSNF	Tgs Asa
COTY	Coty Inc.
CLCO	Cool Company Ltd.
GLYC	GlycoMimetics, Inc.
DEFTF	DeFi Technologies Inc.
AMEH	Apollo Medical Holdings, Inc.
SXYAY	Sika AG
ASLE	AerSale Corporation
USCB	USCB Financial Holdings, Inc.
PXS	Pyxis Tankers Inc.
BLNE	Eastside Distilling, Inc.
EIFZF	Exchange Income Corporation
BEST	BEST Inc.
HPURF	Hexagon Purus ASA
BLRX	BioLineRx Ltd.
EQGPF	EQB Inc.
PCRFF	Panasonic Holdings Corporation
ZZHGF	ZhongAn Online P & C Insurance Co., Ltd.
DAO	Youdao, Inc.
ARKAF	Arkema S.A.
CDNIF	Compañía de Distribución Integral Logista Holdings, S.A.
FUTU	Futu Holdings Limited
RGF	The Real Good Food Company, Inc.
AEBZY	Anadolu Efes Biracilik ve Malt Sanayii Anonim Sirketi
TC	TuanChe Limited
CFXTF	Conifex Timber Inc.
SERA	Sera Prognostics, Inc.
ADRZF	Andritz AG
INSE	Inspired Entertainment, Inc.
WDC	Western Digital Corporation
THTX	Theratechnologies Inc.
EADSF	Airbus SE
WHF	WhiteHorse Finance, Inc.
LCUT	Lifetime Brands, Inc.
DTM	DT Midstream, Inc.
WHD	Cactus, Inc.
NCTY	The9 Limited
IMOS	ChipMOS TECHNOLOGIES Inc.
EMAN	eMagin Corporation
MESA	Mesa Air Group, Inc.
MALRF	Mineral Resources Limited
ASPS	Altisource Portfolio Solutions S.A.
WAB	Westinghouse Air Brake Technologies Corporation
NTIOF	National Bank of Canada
SOL	Emeren Group, Ltd.
KULR	KULR Technology Group, Inc.
NDSN	Nordson Corporation
ISUNQ	iSun, Inc.
WDS	Woodside Energy Group Ltd
CBLL	CeriBell, Inc.
VLOUF	Vallourec S.A.
RAIL	FreightCar America, Inc.
DLR	Digital Realty Trust, Inc.
FECCF	Frontera Energy Corporation
TSLX	Sixth Street Specialty Lending, Inc.
GH	Guardant Health, Inc.
ZLAB	Zai Lab Limited
CPHRF	Cipher Pharmaceuticals Inc.
NOAH	Noah Holdings Limited
UPMKF	UPM-Kymmene Oyj
BEEP	Mobile Infrastructure Corporation
NTWK	NetSol Technologies, Inc.
TTE	TotalEnergies SE
WDGJF	John Wood Group PLC
ARMP	Armata Pharmaceuticals, Inc.
HPGLY	Hapag-Lloyd AG
LPL	LG Display Co., Ltd.
JOE	The St. Joe Company
JDEPF	JDE Peet's N.V.
MLSS	Milestone Scientific Inc.
PSNY	Polestar Automotive Holding UK PLC
BXP	Boston Properties, Inc.
GNSS	Genasys Inc.
CFMS	Conformis, Inc.
KHNGF	Kuehne + Nagel International AG
CINF	Cincinnati Financial Corporation
CCL	Carnival Corporation & plc
GDIFF	GDI Integrated Facility Services Inc.
GRRR	Gorilla Technology Group Inc.
KITT	Nauticus Robotics, Inc.
NETL	Fundamental Income Net Lease Real Estate ETF
SN	SharkNinja, Inc.
BGI	Birks Group Inc.
RTC	Baijiayun Group Ltd
VOXX	VOXX International Corporation
FSPKF	Fisher & Paykel Healthcare Corporation Limited
TYL	Tyler Technologies, Inc.
PGRE	Paramount Group, Inc.
AKRTF	Aker Solutions ASA
CSX	CSX Corporation
FINGF	Finning International Inc.
BLGO	BioLargo, Inc.
VSTM	Verastem, Inc.
SST	System1, Inc.
CGEAF	Cogeco Communications Inc.
WELL	Welltower Inc.
IVA	Inventiva S.A.
QUIK	QuickLogic Corporation
GIPR	Generation Income Properties, Inc.
CTOWY	China Tower Corporation Limited
CRGO	Freightos Limited Ordinary shares
WYNN	Wynn Resorts, Limited
EOG	EOG Resources, Inc.
WBX	Wallbox N.V.
FLR	Fluor Corporation
WLDBF	WildBrain Ltd.
BTTX	Better Therapeutics, Inc.
ZONNF	Nos, S.g.p.s., S.a.
NCLH	Norwegian Cruise Line Holdings Ltd.
AIRG	Airgain, Inc.
RNWEF	REC Silicon ASA
RIO	Rio Tinto Group
AVACF	Avance Gas Holding Ltd
OCLCF	Oracle Corporation Japan
NYAX	Nayax Ltd.
LEV	The Lion Electric Company
SCI	Service Corporation International
TKO	TKO Group Holdings, Inc.
DSEY	Diversey Holdings, Ltd.
FGRRF	Fingerprint Cards AB (publ)
PSYTF	Pason Systems Inc.
OGFGF	Origin Energy Limited
XTRAF	Xtract One Technologies Inc.
LPSN	LivePerson, Inc.
MNTK	Montauk Renewables, Inc.
RAIFF	Raiffeisen Bank International AG
KBAL	Kimball International, Inc.
EQR	Equity Residential
ARCVF	Arcadis N.V.
IOBCF	Ion Beam Applications S.A.
LU	Lufax Holding Ltd
ATASF	Atlantia S.p.A.
MMM	3M Company
MLLGF	Mullen Group Ltd.
RKNEF	Optiva Inc.
SLGC	SomaLogic, Inc.
NAVB	Navidea Biopharmaceuticals, Inc.
AOS	A. O. Smith Corporation
TMVWF	TeamViewer AG
FURCF	Forvia SE
UA	Under Armour, Inc.
MNGPF	Man Group Limited
AMIGF	Admiral Group plc
EMN	Eastman Chemical Company
LVO	LiveOne, Inc.
TTM	Tata Motors Limited
UNCRY	UniCredit S.p.A.
CCORF	Canaccord Genuity Group Inc.
MSTR	MicroStrategy Incorporated
EQBBF	EQT AB (publ)
FND	Floor & Decor Holdings, Inc.
GMRE	Global Medical REIT Inc.
BBNX	Beta Bionics, Inc.
WPRT	Westport Fuel Systems Inc.
LCSHF	Lancashire Holdings Limited
AXFOF	Axfood AB (publ)
AER	AerCap Holdings N.V.
UFAB	Unique Fabricating, Inc.
TDOC	Teladoc Health, Inc.
EVOK	Evoke Pharma, Inc.
FUL	H.B. Fuller Company
QS	QuantumScape Corporation
NPSNY	Naspers Limited
CTSDF	Converge Technology Solutions Corp.
TSAT	Telesat Corporation
TCLAF	Transcontinental Inc.
GURE	Gulf Resources, Inc.
BORR	Borr Drilling Limited
MARK	Remark Holdings, Inc.
ICE	Intercontinental Exchange, Inc.
AIP	Arteris, Inc.
GBCI	Glacier Bancorp, Inc.
SDOT	Sadot Group Inc.
ONL	Orion Properties Inc.
AREN	The Arena Group Holdings, Inc.
ARZGF	Assicurazioni Generali S.p.A.
HLMAF	Halma plc
ITP	IT Tech Packaging, Inc.
TTNDY	Techtronic Industries Company Limited
EHMEF	goeasy Ltd.
NBN	Northeast Bank
CLH	Clean Harbors, Inc.
NEO	NeoGenomics, Inc.
TEN	Tsakos Energy Navigation Limited
CPSH	CPS Technologies Corporation
MPAA	Motorcar Parts of America, Inc.
CVLG	Covenant Logistics Group, Inc.
FVRR	Fiverr International Ltd.
CFB	CrossFirst Bankshares, Inc.
BLKB	Blackbaud, Inc.
COF	Capital One Financial Corporation
GOOGL	Alphabet Inc.
VIPS	Vipshop Holdings Limited
SCCAF	Sleep Country Canada Holdings Inc.
PFBC	Preferred Bank
VIV	Telefônica Brasil S.A.
MAS	Masco Corporation
NSPR	InspireMD, Inc.
BWB	Bridgewater Bancshares, Inc.
IDCC	InterDigital, Inc.
WKC	World Kinect Corporation
AIOT	PowerFleet, Inc.
VIR	Vir Biotechnology, Inc.
IAUX	i-80 Gold Corp.
NVRI	Enviri Corporation
GSK	GSK plc
KNRLF	Kontrol Technologies Corp.
RNGR	Ranger Energy Services, Inc.
LAUR	Laureate Education, Inc.
GRCL	Gracell Biotechnologies Inc.
JD	JD.com, Inc.
BSM	Black Stone Minerals, L.P.
ORA	Ormat Technologies, Inc.
CALT	Calliditas Therapeutics AB (publ)
ZIZTF	Zip Co Limited
AFMD	Affimed N.V.
DLAKF	Deutsche Lufthansa AG
SAMG	Silvercrest Asset Management Group Inc.
CCO	Clear Channel Outdoor Holdings, Inc.
BNR	Burning Rock Biotech Limited
EPM	Evolution Petroleum Corporation
ORAAF	Aura Minerals Inc.
CCRN	Cross Country Healthcare, Inc.
SQSP	Squarespace, Inc.
WFG	West Fraser Timber Co. Ltd.
RMCF	Rocky Mountain Chocolate Factory, Inc.
ATAT	Atour Lifestyle Holdings Limited
UAL	United Airlines Holdings, Inc.
CSCO	Cisco Systems, Inc.
MTRN	Materion Corporation
REGI	Renewable Energy Group, Inc.
BXS	BancorpSouth Bank
PKX	POSCO Holdings Inc.
ITMSF	Intermap Technologies Corporation
BHTG	Renovare Environmental, Inc.
XFABF	X-FAB Silicon Foundries SE
RWAY	Runway Growth Finance Corp.
XPEV	XPeng Inc.
CERS	Cerus Corporation
AMG	Affiliated Managers Group, Inc.
MCUJF	Medicure Inc.
TSP	TuSimple Holdings Inc.
DS	Drive Shack Inc.
NTXVF	Nexteer Automotive Group Limited
PACB	Pacific Biosciences of California, Inc.
BCPC	Balchem Corporation
RPAY	Repay Holdings Corporation
TTCFQ	Tattooed Chef, Inc.
QNCX	Quince Therapeutics, Inc.
CHGCF	Chugai Pharmaceutical Co., Ltd.
HCHC	HC2 Holdings, Inc.
PFS	Provident Financial Services, Inc.
UHG	United Homes Group, Inc.
X	United States Steel Corporation
CSWI	CSW Industrials, Inc.
GGB	Gerdau S.A.
CLNFF	Calian Group Ltd.
UNFI	United Natural Foods, Inc.
GPX	GP Strategies Corporation
DVCR	Diversicare Healthcare Services, Inc.
ZUO	Zuora, Inc.
LMNX	Luminex Corporation
DPW	BitNile Holdings, Inc.
CYAD	Celyad Oncology S.A.
GOOG	Alphabet Inc.
RDY	Dr. Reddy's Laboratories Limited
CLNE	Clean Energy Fuels Corp.
FCN	FTI Consulting, Inc.
STIXF	Semantix, Inc.
AS	Amer Sports, Inc.
MSIF	MSC Income Fund, Inc.
ELEZF	Endesa, S.A.
JMHLY	Jardine Matheson Holdings Limited
DSHK	Drive Shack Inc.
VFF	Village Farms International, Inc.
SFL	SFL Corporation Ltd.
ECOL	US Ecology, Inc.
LPTV	Loop Media, Inc.
BTCM	BIT Mining Limited
CWEN	Clearway Energy, Inc.
SNCE	Science 37 Holdings, Inc.
MCO	Moody's Corporation
RKLB	Rocket Lab USA, Inc.
BTMD	biote Corp.
SNAX	Stryve Foods, Inc.
TMXXF	TMX Group Limited
ORAN	Orange S.A.
ASPN	Aspen Aerogels, Inc.
PRTC	PureTech Health plc
GCTAF	Siemens Gamesa Renewable Energy, S.A.
BEAM	Beam Therapeutics Inc.
KUASF	Kuaishou Technology
PAE	PAE Incorporated
TWLO	Twilio Inc.
HII	Huntington Ingalls Industries, Inc.
BALY	Bally's Corporation
HWCC	Houston Wire & Cable Company
HTH	Hilltop Holdings Inc.
CCCS	CCC Intelligent Solutions Holdings Inc.
RM	Regional Management Corp.
BBQ	BBQ Holdings, Inc.
CSLT	Castlight Health, Inc.
TIGR	UP Fintech Holding Limited
PHI	PLDT Inc.
SMCI	Super Micro Computer, Inc.
WUXIF	WuXi AppTec Co., Ltd.
ACBI	Atlantic Capital Bancshares, Inc.
ALSRF	alstria office REIT-AG
UMICF	Umicore S.A.
AGTC	Applied Genetic Technologies Corporation
ENVA	Enova International, Inc.
IGXT	IntelGenx Technologies Corp.
LBLCF	Loblaw Companies Limited
RPAI	Retail Properties of America, Inc.
ALEAF	Aleafia Health Inc.
CIT	CIT Group Inc.
OSN	Ossen Innovation Co., Ltd.
KRA	Kraton Corporation
PLAY	Dave & Buster's Entertainment, Inc.
WLK	Westlake Corporation
SYTA	Siyata Mobile Inc.
AHT	Ashford Hospitality Trust, Inc.
BQ	Boqii Holding Limited
LCID	Lucid Group, Inc.
TRU	TransUnion
RCUS	Arcus Biosciences, Inc.
NYMT	New York Mortgage Trust, Inc.
CFR	Cullen/Frost Bankers, Inc.
HBNC	Horizon Bancorp, Inc.
SABR	Sabre Corporation
EONGY	E.on Se
AIN	Albany International Corp.
RXN	Zurn Water Solutions Corporation
JPPYY	Jupai Holdings Limited
SPOK	Spok Holdings, Inc.
TV	Grupo Televisa, S.A.B.
MKTW	MarketWise, Inc.
SNMP	Evolve Transition Infrastructure LP
ASB	Associated Banc-Corp
RBGPF	Reckitt Benckiser Group plc
CLDR	Cloudera, Inc.
PHR	Phreesia, Inc.
MYRG	MYR Group Inc.
TUEMQ	Tuesday Morning Corporation
LTRPA	Liberty TripAdvisor Holdings, Inc.
NAYA	NAYA Biosciences, Inc.
AZRE	Azure Power Global Limited
CGNX	Cognex Corporation
RRGB	Red Robin Gourmet Burgers, Inc.
FSNUF	Fresenius SE & Co. KGaA
UDMY	Udemy, Inc.
LONE	Lonestar Resources US Inc.
SBGSF	Schneider Electric S.E.
WGS	GeneDx Holdings Corp.
USAS	Americas Gold and Silver Corporation
ATNX	Athenex, Inc.
ALYAF	Alithya Group Inc.
GIII	G-III Apparel Group, Ltd.
BKE	The Buckle, Inc.
NTUS	Natus Medical Incorporated
SWX	Southwest Gas Holdings, Inc.
GPL	Great Panther Mining Limited
ENFN	Enfusion, Inc.
WST	West Pharmaceutical Services, Inc.
SSP	The E.W. Scripps Company
BAESF	BAE Systems plc
TRSSF	TerrAscend Corp.
MGNX	MacroGenics, Inc.
SPR	Spirit AeroSystems Holdings, Inc.
RIBT	RiceBran Technologies
BKKT	Bakkt Holdings, Inc.
FTGFF	Firan Technology Group Corporation
USCR	U.S. Concrete, Inc.
XPER	Xperi Inc.
TKGBF	Turkiye Garanti Bankasi A.S.
DAVA	Endava plc
RBBN	Ribbon Communications Inc.
MTW	The Manitowoc Company, Inc.
UFS	Domtar Corporation
SBHGF	SBI Holdings, Inc.
LDNXF	London Stock Exchange Group plc
RJF	Raymond James Financial, Inc.
KEYS	Keysight Technologies, Inc.
FSLY	Fastly, Inc.
RCI	Rogers Communications Inc.
PTCT	PTC Therapeutics, Inc.
IRDM	Iridium Communications Inc.
SAIC	Science Applications International Corporation
EIX	Edison International
ABEV	Ambev S.A.
AVXL	Anavex Life Sciences Corp.
ALKT	Alkami Technology, Inc.
SLFPF	Abrdn Plc
SQBG	Sequential Brands Group, Inc.
CDMGF	Icade S.A.
ADP	Automatic Data Processing, Inc.
XLNX	Xilinx, Inc.
VICI	VICI Properties Inc.
IBM	International Business Machines Corporation
LGDDF	Lagardere S.A.
AUB	Atlantic Union Bankshares Corporation
DEO	Diageo plc
WASH	Washington Trust Bancorp, Inc.
LBRDP	Liberty Broadband Corporation
AWR	American States Water Company
SWKH	SWK Holdings Corporation
ABMD	Abiomed, Inc.
SJR	Shaw Communications Inc.
SFD	Smithfield Foods, Inc.
BIOL	BIOLASE, Inc.
ITMPF	ITM Power Plc
KNSA	Kiniksa Pharmaceuticals, Ltd.
ZNGA	Zynga Inc.
DISCA	Warner Bros. Discovery, Inc.
MANU	Manchester United plc
VQSSF	VIQ Solutions Inc.
CERN	Cerner Corporation
BKD	Brookdale Senior Living Inc.
VEV	Vicinity Motor Corp.
BIIB	Biogen Inc.
AIXXF	Aixtron Se
AXU	Alexco Resource Corp.
INFN	Infinera Corporation
SEMHF	Siemens Healthineers AG
EQIX	Equinix, Inc.
CSTL	Castle Biosciences, Inc.
BYD	Boyd Gaming Corporation
FCELB	FuelCell Energy, Inc.
TRRSF	Trisura Group Ltd.
NBEV	NewAge, Inc.
EPR	EPR Properties
IGT	International Game Technology PLC
MYO	Myomo, Inc.
STT	State Street Corporation
ANSLY	Ansell Limited
SUNE	SUNation Energy Inc.
PVG	Pretium Resources Inc.
FENG	Phoenix New Media Limited
BLMN	Bloomin' Brands, Inc.
MPFRF	Mapfre, S.A.
TPZEF	Topaz Energy Corp.
WLKP	Westlake Chemical Partners LP
PROS	ProSight Global, Inc.
SYNL	Synalloy Corporation
AGS	PlayAGS, Inc.
GNCA	Genocea Biosciences, Inc.
PRU	Prudential Financial, Inc.
EVRI	Everi Holdings Inc.
JMP	JMP Group LLC
VERO	Venus Concept Inc.
SCOR	comScore, Inc.
HNGR	Hanger, Inc.
EMMS	Emmis Corporation
LDL	Lydall, Inc.
RBC	RBC Bearings Incorporated
ECVT	Ecovyst Inc.
CELP	Cypress Environmental Partners, L.P.
HHH	Howard Hughes Holdings Inc.
DMGGF	DMG Blockchain Solutions Inc.
NMRK	Newmark Group, Inc.
BOOT	Boot Barn Holdings, Inc.
ERO	Ero Copper Corp.
KTCC	Key Tronic Corporation
COMS	COMSovereign Holding Corp.
CAR	Avis Budget Group, Inc.
ATGFF	AltaGas Ltd.
GPN	Global Payments Inc.
TMICY	Trend Micro Incorporated
EVOTF	Evotec SE
CHT	Chunghwa Telecom Co., Ltd.
QSI	Quantum-Si incorporated
ZOM	Zomedica Corp.
SANM	Sanmina Corporation
RMD	ResMed Inc.
UCBI	United Community Banks, Inc.
NEOG	Neogen Corporation
SMG	The Scotts Miracle-Gro Company
WEC	WEC Energy Group, Inc.
CENT	Central Garden & Pet Company
ARCC	Ares Capital Corporation
LFT	Lument Finance Trust, Inc.
SCHL	Scholastic Corporation
TCS	The Container Store Group, Inc.
OWLT	Owlet, Inc.
BLCO	Bausch + Lomb Corporation
ONDS	Ondas Holdings Inc.
JETMF	Global Crossing Airlines Group Inc.
IBP	Installed Building Products, Inc.
MTB	M&T Bank Corporation
PBFX	PBF Logistics LP
DVDCF	Davide Campari-Milano N.V.
IMCR	Immunocore Holdings plc
LTH	Life Time Group Holdings, Inc.
REPYF	Repsol, S.A.
ARKO	Arko Corp.
CHRS	Coherus BioSciences, Inc.
XXII	22nd Century Group, Inc.
O	Realty Income Corporation
ISUN	iSun, Inc.
MAHMF	Mahindra & Mahindra Limited
ARAFF	Arafura Rare Earths Limited
WU	The Western Union Company
ERIC	Telefonaktiebolaget LM Ericsson (publ)
BMNM	Bimini Capital Management, Inc.
FORA	Forian Inc.
SKSBF	Skanska AB (publ)
HUBG	Hub Group, Inc.
BXSL	Blackstone Secured Lending Fund
NHIQ	NantHealth, Inc.
NRP	Natural Resource Partners L.P.
ACSYF	Accsys Technologies PLC
DRVN	Driven Brands Holdings Inc.
GNNSF	Genscript Biotech Corporation
CSLR	Complete Solaria, Inc.
ANZFF	Air New Zealand Limited
SNEJF	Sony Group Corporation
ALT	Altimmune, Inc.
MMSI	Merit Medical Systems, Inc.
MODG	Topgolf Callaway Brands Corp.
NOVKY	Pao Novatek
HOFT	Hooker Furnishings Corporation
MPVDF	Mountain Province Diamonds Inc.
SUNWQ	Sunworks, Inc.
PESAF	Panoro Energy ASA
CMCSA	Comcast Corporation
GVP	GSE Systems, Inc.
TCTZF	Tencent Holdings Limited
UNIT	Uniti Group Inc.
ETD	Ethan Allen Interiors Inc.
ATKR	Atkore Inc.
AXDX	Accelerate Diagnostics, Inc.
AMRC	Ameresco, Inc.
MUR	Murphy Oil Corporation
NVGS	Navigator Holdings Ltd.
ALSMY	Alstom S.A.
ACMR	ACM Research, Inc.
INFO	Harbor PanAgora Dynamic Large Cap Core ETF
AYRWF	Ayr Wellness Inc.
TEX	Terex Corporation
NANX	Nanophase Technologies Corporation
CRC	California Resources Corporation
CVS	CVS Health Corporation
GAIA	Gaia, Inc.
ASXC	Asensus Surgical, Inc.
G	Genpact Limited
SMR	NuScale Power Corporation
INFA	Informatica Inc.
KGAUF	Kongsberg Automotive ASA
INDV	Indivior PLC
HYMTF	Hyundai Motor Company
QMCO	Quantum Corporation
AI	C3.ai, Inc.
CCIF	Carlyle Credit Income Fund
LTOUF	Larsen & Toubro Limited
IVFH	Innovative Food Holdings, Inc.
AFBOF	African Rainbow Minerals Limited
UIHC	United Insurance Holdings Corp.
ARQ	Arq, Inc.
OPK	OPKO Health, Inc.
DVA	DaVita Inc.
GE	GE Aerospace
MGRC	McGrath RentCorp
EHTH	eHealth, Inc.
HGHAF	High Arctic Energy Services Inc
MTTR	Matterport, Inc.
BANL	CBL International Limited
COLM	Columbia Sportswear Company
GTH	Genetron Holdings Limited
LUV	Southwest Airlines Co.
SYNH	Syneos Health, Inc.
CLAR	Clarus Corporation
MU	Micron Technology, Inc.
CRTO	Criteo S.A.
YGYI	Youngevity International, Inc.
RS	Reliance Steel & Aluminum Co.
RDW	Redwire Corporation
INUV	Inuvo, Inc.
FRTX	Fresh Tracks Therapeutics, Inc.
PRGS	Progress Software Corporation
FIBK	First Interstate BancSystem, Inc.
BUKS	Butler National Corporation
AGESY	ageas SA/NV
RIG	Transocean Ltd.
GAXYQ	Galaxy Next Generation, Inc.
ATER	Aterian, Inc.
AHEXF	Adecco Group AG
HLTH	Cue Health Inc.
ELKEF	Elkem ASA
HRTX	Heron Therapeutics, Inc.
FUVV	Arcimoto, Inc.
TLMD	SOC Telemed, Inc.
F	Ford Motor Company
CRH	CRH plc
CRWS	Crown Crafts, Inc.
AZPN	Aspen Technology, Inc.
PX	P10, Inc.
CASI	CASI Pharmaceuticals, Inc.
PLMR	Palomar Holdings, Inc.
NEU	NewMarket Corporation
BYRN	Byrna Technologies Inc.
PYPL	PayPal Holdings, Inc.
BKRIF	Bank of Ireland Group plc
RANJF	Randstad N.V.
IBEX	IBEX Limited
MMTOF	Mitsubishi Motors Corporation
RDN	Radian Group Inc.
SMRT	SmartRent, Inc.
CTMX	CytomX Therapeutics, Inc.
WTER	The Alkaline Water Company Inc.
NIPNF	NEC Corporation
DBX	Dropbox, Inc.
LEE	Lee Enterprises, Incorporated
URI	United Rentals, Inc.
KDDIY	KDDI Corporation
NNWWF	The North West Company Inc.
FNA	Paragon 28, Inc.
AGXXF	Agilyx ASA
HST	Host Hotels & Resorts, Inc.
ENPH	Enphase Energy, Inc.
JBHT	J.B. Hunt Transport Services, Inc.
CAIXY	CaixaBank, S.A.
HMDPF	Hammond Power Solutions Inc.
JLL	Jones Lang LaSalle Incorporated
VIVS	VivoSim Labs, Inc.
VATE	INNOVATE Corp.
ASR	Grupo Aeroportuario del Sureste, S. A. B. de C. V.
ZLDPF	Zealand Pharma A/S
IESC	IES Holdings, Inc.
SEM	Select Medical Holdings Corporation
AIVAF	Aviva plc
LODE	Comstock Inc.
GTM	ZoomInfo Technologies Inc.
HTO	H2O America
MYTE	MYT Netherlands Parent B.V.
LIFW	MSP Recovery, Inc.
PODC	PodcastOne, Inc.
META	Meta Platforms, Inc.
BTE	Baytex Energy Corp.
TRATF	Traton SE
DADA	Dada Nexus Limited
PCELF	PowerCell Sweden AB (publ)
MRVI	Maravai LifeSciences Holdings, Inc.
LAKE	Lakeland Industries, Inc.
HLX	Helix Energy Solutions Group, Inc.
RCEL	AVITA Medical, Inc.
UBLXF	u-blox Holding AG
VRBCF	Virbac S.A.
UNBLF	Unibail-Rodamco-Westfield SE
SPCB	SuperCom Ltd.
WYGPF	Worley Limited
AUTL	Autolus Therapeutics plc
PDYPY	Flutter Entertainment plc
GPMT	Granite Point Mortgage Trust Inc.
CMBM	Cambium Networks Corporation
MNDJF	Mandalay Resources Corporation
EVLV	Evolv Technologies Holdings, Inc.
GTN	Gray Television, Inc.
VFS	VinFast Auto Ltd.
ETR	Entergy Corporation
WBRBY	Wienerberger AG
ARLUF	Aristocrat Leisure Limited
HOG	Harley-Davidson, Inc.
HLT	Hilton Worldwide Holdings Inc.
BAFBF	Balfour Beatty plc
ERELY	Eregli Demir ve Çelik Fabrikalari T.A.S.
BECTY	Bechtle AG
ULBI	Ultralife Corporation
GMED	Globus Medical, Inc.
BROS	Dutch Bros Inc.
CCHBF	Coca-Cola HBC AG
HIPO	Hippo Holdings Inc.
INSP	Inspire Medical Systems, Inc.
CLCMF	Sinch AB (publ)
NYCB	New York Community Bancorp, Inc.
EDSA	Edesa Biotech, Inc.
BFIN	BankFinancial Corporation
WLFC	Willis Lease Finance Corporation
EIG	Employers Holdings, Inc.
WNC	Wabash National Corporation
TMDX	TransMedics Group, Inc.
AWH	Aspira Women's Health Inc.
SKIN	The Beauty Health Company
NEXA	Nexa Resources S.A.
BOOM	DMC Global Inc.
MLXSF	Melexis N.V.
DSNY	Destiny Media Technologies Inc.
BZLYF	Beazley plc
EGKLF	ElringKlinger AG
SMWB	Similarweb Ltd.
CNPOF	RIV Capital Inc.
PMT	PennyMac Mortgage Investment Trust
MITK	Mitek Systems, Inc.
EQC	Equity Commonwealth
AVAH	Aveanna Healthcare Holdings Inc.
ESEA	Euroseas Ltd.
BYDGF	Boyd Group Services Inc.
KHC	The Kraft Heinz Company
EBAY	eBay Inc.
SMTC	Semtech Corporation
BROG	Brooge Energy Limited
601318.SS	Ping An Insurance (Group) Company of China, Ltd.
IONS	Ionis Pharmaceuticals, Inc.
FLWPF	The Flowr Corporation
DCPH	Deciphera Pharmaceuticals, Inc.
AHOTF	American Hotel Income Properties REIT LP
EVBN	Evans Bancorp, Inc.
CCEP	Coca-Cola Europacific Partners PLC
VLY	Valley National Bancorp
PYRGF	PyroGenesis Canada Inc.
TDY	Teledyne Technologies Incorporated
GTES	Gates Industrial Corporation plc
JRONF	Jerónimo Martins, SGPS, S.A.
GILD	Gilead Sciences, Inc.
FUPEF	Fuchs Petrolub SE
CYH	Community Health Systems, Inc.
CSTE	Caesarstone Ltd.
GECC	Great Elm Capital Corp.
ATEC	Alphatec Holdings, Inc.
SBSW	Sibanye Stillwater Limited
HOCFF	Hochtief AG
HOLX	Hologic, Inc.
STON	StoneMor Inc.
PPSI	Pioneer Power Solutions, Inc.
NBGIF	National Bank of Greece S.A.
SBS	Companhia de Saneamento Básico do Estado de São Paulo - SABESP
COE	China Online Education Group
AQN	Algonquin Power & Utilities Corp.
OCFT	OneConnect Financial Technology Co., Ltd.
ES	Eversource Energy
TUYA	Tuya Inc.
PFC	Premier Financial Corp.
GOGO	Gogo Inc.
ISPC	iSpecimen Inc.
IPHYF	Innate Pharma S.A.
GZPZF	Gaztransport & Technigaz S.A.
GRBK	Green Brick Partners, Inc.
IVTBF	Investment AB Latour (publ)
CHK	Chesapeake Energy Corporation
LTTHF	Learning Technologies Group plc
BAK	Braskem S.A.
RHUHF	Richelieu Hardware Ltd.
UGRO	urban-gro, Inc.
MTX	Minerals Technologies Inc.
DRIO	DarioHealth Corp.
CNXN	PC Connection, Inc.
AKCCF	Aker Carbon Capture ASA
NFG	National Fuel Gas Company
WBK	Westpac Banking Corporation
CPAC	Cementos Pacasmayo S.A.A.
ROIC	Retail Opportunity Investments Corp.
NLST	Netlist, Inc.
NINE	Nine Energy Service, Inc.
XBIO	Xenetic Biosciences, Inc.
CNMD	CONMED Corporation
THNPY	Technip Energies N.V.
MNR	Mach Natural Resources LP
USB	U.S. Bancorp
MFON	Mobivity Holdings Corp.
IDCBY	Industrial & Commercial Bank of China Ltd.
TGVSF	Tryg A/S
CNTMF	Cansortium Inc.
UNH	UnitedHealth Group Incorporated
SASR	Sandy Spring Bancorp, Inc.
MODV	ModivCare Inc.
SDGR	Schrödinger, Inc.
THBRF	Thunderbird Entertainment Group Inc.
BIDU	Baidu, Inc.
LI	Li Auto Inc.
SFFYF	Signify N.V.
ADCT	ADC Therapeutics S.A.
CUTR	Cutera, Inc.
ARVL	Arrival
SOBO	South Bow Corporation
RVNC	Revance Therapeutics, Inc.
WISA	WiSA Technologies, Inc.
SUPGF	Superior Gold Inc.
VNNVF	Vonovia SE
ANGPY	Anglo American Platinum Limited
SLCJY	SLC Agrícola S.A.
CDLX	Cardlytics, Inc.
OLGPF	Olam Group Limited
ETTYF	Essity AB (publ)
ATLC	Atlanticus Holdings Corporation
FXLV	F45 Training Holdings Inc.
STCN	Steel Connect, Inc.
MEI	Methode Electronics, Inc.
601288.SS	Agricultural Bank of China Limited
BSMX	Banco Santander México, S.A., Institución de Banca Múltiple, Grupo Financiero Santander México
KIDS	OrthoPediatrics Corp.
BA	The Boeing Company
NNCSF	Nanosonics Limited
TBABF	Trelleborg AB (publ)
HASI	Hannon Armstrong Sustainable Infrastructure Capital, Inc.
FOJCF	Fortum Oyj
FF	FutureFuel Corp.
002202.SZ	Xinjiang Goldwind Science & Technology Co., Ltd.
BC	Brunswick Corporation
SCWX	SecureWorks Corp.
LIQT	LiqTech International, Inc.
TCYSF	Tecsys Inc.
OMQS	OMNIQ Corp.
PYTCF	Playtech plc
CAN	Canaan Inc.
KB	KB Financial Group Inc.
MAPIF	Mapletree Industrial Trust
TISI	Team, Inc.
SSEZF	SSE plc
STLA	Stellantis N.V.
GLBS	Globus Maritime Limited
HSAI	Hesai Group
HLIO	Helios Technologies, Inc.
IWSY	ImageWare Systems, Inc.
HMY	Harmony Gold Mining Company Limited
CTRA	Coterra Energy Inc.
HYFM	Hydrofarm Holdings Group, Inc.
RELY	Remitly Global, Inc.
LXU	LSB Industries, Inc.
CMPGF	Compass Group PLC
ATO	Atmos Energy Corporation
RLLCF	Rolls-Royce Holdings plc
FMCC	Federal Home Loan Mortgage Corporation
AGCO	AGCO Corporation
NWE	Northwestern Energy Group Inc
BLNK	Blink Charging Co.
HFFG	HF Foods Group Inc.
VRT	Vertiv Holdings Co
PITAF	Poste Italiane S.p.A.
RKWBF	Rockwool A/S
HDIUF	ADENTRA Inc.
CRIS	Curis, Inc.
TBVPF	Thai Beverage Public Company Limited
RWT	Redwood Trust, Inc.
VALN	Valneva SE
SPHR	Sphere Entertainment Co.
MOMO	Hello Group Inc.
LGMK	LogicMark, Inc.
MYGN	Myriad Genetics, Inc.
HELE	Helen of Troy Limited
LTRY	Lottery.com Inc.
KRNGF	Karoon Energy Ltd
ACXIF	Acciona, S.A.
STOSF	Santos Limited
NINOY	Nikon Corporation
HDSN	Hudson Technologies, Inc.
BBBY	Bed Bath & Beyond Inc.
SONVF	Sonova Holding AG
AMSC	American Superconductor Corporation
ANIP	ANI Pharmaceuticals, Inc.
VIRI	Virios Therapeutics, Inc.
LEN	Lennar Corporation
HVT	Haverty Furniture Companies, Inc.
SPXSF	Spirax-Sarco Engineering plc
SREDF	Storebrand ASA
OCDGF	Ocado Group plc
SRHGF	Shoprite Holdings Limited
FNMA	Federal National Mortgage Association
HTLF	Heartland Financial USA, Inc.
TMICF	Trend Micro Incorporated
TSCDF	Tesco PLC
FLG	Flagstar Financial, Inc.
RDBBF	Redbubble Limited
JXN	Jackson Financial Inc.
ELUT	Elutia Inc.
BDSI	BioDelivery Sciences International, Inc.
THG	The Hanover Insurance Group, Inc.
SLN	Silence Therapeutics plc
AIBGY	AIB Group plc
BDRX	Biodexa Pharmaceuticals Plc
ACSAF	ACS, Actividades de Construcción y Servicios, S.A.
NI	NiSource Inc.
AMYT	Amryt Pharma plc
ACGL	Arch Capital Group Ltd.
CHD	Church & Dwight Co., Inc.
MN	Manning & Napier, Inc.
GDS	GDS Holdings Limited
OABI	OmniAb, Inc.
ALGT	Allegiant Travel Company
FRTAF	freenet AG
AYTU	Aytu BioPharma, Inc.
ENIC	Enel Chile S.A.
CBDHF	Hempfusion Wellness Inc.
SPKKY	Spark New Zealand Limited
MTP	Midatech Pharma plc
STAA	STAAR Surgical Company
WS	Worthington Steel, Inc.
BZUN	Baozun Inc.
NTZ	Natuzzi S.p.A.
CLEGF	Coles Group Limited
AIMC	Altra Industrial Motion Corp.
TLRY	Tilray Brands, Inc.
PANW	Palo Alto Networks, Inc.
HTGMQ	HTG Molecular Diagnostics, Inc.
VOD	Vodafone Group Public Limited Company
MXCT	MaxCyte, Inc.
NAV	Navistar International Corporation
GRTS	Gritstone bio, Inc.
EPAY	Bottomline Technologies, Inc.
KLXE	KLX Energy Services Holdings, Inc.
CYRX	Cryoport, Inc.
GENSF	Genus plc
DRKTF	Darktrace plc
AGEN	Agenus Inc.
CIA	Citizens, Inc.
GIGA	Giga-tronics Incorporated
NESR	National Energy Services Reunited Corp.
BAESY	BAE Systems plc
AADI	Aadi Bioscience, Inc.
AXLA	Axcella Health Inc.
AALBF	Aalberts N.V.
KKKUF	Kakaku.com, Inc.
JMIA	Jumia Technologies AG
FREY	FREYR Battery
CO	Global Cord Blood Corporation
INNV	InnovAge Holding Corp.
QIPT	Quipt Home Medical Corp.
QNGY	Quanergy Systems, Inc.
TBLT	ToughBuilt Industries, Inc.
PIII	P3 Health Partners Inc.
KFRC	Kforce Inc.
LGGNF	Legal & General Group Plc
SNIPF	Snipp Interactive Inc.
VISL	Vislink Technologies, Inc.
KMX	CarMax, Inc.
AFCG	AFC Gamma, Inc.
VLXGF	Volex plc
RELV	Reliv' International, Inc.
AUMN	Golden Minerals Company
BPMC	Blueprint Medicines Corporation
AGR	Avangrid, Inc.
LUVU	Luvu Brands, Inc.
SATS	EchoStar Corporation
ASMVF	ASMPT Limited
SMTSF	Sierra Metals Inc.
AMR	Alpha Metallurgical Resources, Inc.
BAH	Booz Allen Hamilton Holding Corporation
INGR	Ingredion Incorporated
BLX	Banco Latinoamericano de Comercio Exterior, S. A.
VLTO	Veralto Corporation
LICY	Li-Cycle Holdings Corp.
GASNF	Naturgy Energy Group, S.A.
LHCG	LHC Group, Inc.
PBTHF	PointsBet Holdings Limited
TMGEF	Thermal Energy International Inc.
BHP	BHP Group Limited
CURV	Torrid Holdings Inc.
LSDAF	Lassonde Industries Inc.
CREG	Smart Powerr Corp.
BDORY	Banco do Brasil S.A.
NMR	Nomura Holdings, Inc.
SECOY	Secoo Holding Limited
YACAF	Yancoal Australia Ltd
AVTR	Avantor, Inc.
CVHSY	Cablevisión Holding S.A.
BEPTF	Beach Energy Limited
NVAX	Novavax, Inc.
SMAR	Smartsheet Inc.
HCXLF	Hiscox Ltd
FIP	FTAI Infrastructure Inc.
BLCM	Bellicum Pharmaceuticals, Inc.
OLN	Olin Corporation
TRVN	Trevena, Inc.
TCPC	BlackRock TCP Capital Corp.
601939.SS	China Construction Bank Corporation
ECNCF	ECN Capital Corp.
IBA	Industrias Bachoco, S.A.B. de C.V.
BGAOY	Proximus PLC
ANY	Sphere 3D Corp.
OI	O-I Glass, Inc.
HAGHY	Hensoldt AG
RLLMF	Real Matters Inc.
SSREY	Swiss Re AG
NES	Nuverra Environmental Solutions, Inc.
CONN	Conn's, Inc.
XP	XP Inc.
BRLT	Brilliant Earth Group, Inc.
EPAC	Enerpac Tool Group Corp.
ALFVY	Alfa Laval AB (publ)
DCMDF	DATA Communications Management Corp.
TKC	Turkcell Iletisim Hizmetleri A.S.
MOND	Mondee Holdings, Inc.
PAA	Plains All American Pipeline, L.P.
SHYF	The Shyft Group, Inc.
STL	Sterling Bancorp
APNHF	Aspen Pharmacare Holdings Limited
NTB	The Bank of N.T. Butterfield & Son Limited
HOUS	Anywhere Real Estate Inc.
KREF	KKR Real Estate Finance Trust Inc.
IZEA	IZEA Worldwide, Inc.
PGR	The Progressive Corporation
SEYMF	Solaria Energía y Medio Ambiente, S.A.
TNGRF	Thungela Resources Limited
NNOCF	Nanoco Group plc
AMKBY	A.P. Møller - Mærsk A/S
KGFHF	Kingfisher plc
OGE	OGE Energy Corp.
NVNXF	Novonix Limited
ENTG	Entegris, Inc.
SGGKF	Singapore Technologies Engineering Ltd
ARESF	Artis Real Estate Investment Trust
TSE	Trinseo PLC
NKE.NE	NIKE, Inc.
TDCX	TDCX Inc.
ALLGF	Allego N.V.
EIGRQ	Eiger BioPharmaceuticals, Inc.
HSBC	HSBC Holdings plc
RSVR	Reservoir Media, Inc.
CRVS	Corvus Pharmaceuticals, Inc.
SSAAF	SSAB AB (publ)
FBMS	The First Bancshares, Inc.
NTCO	Natura &Co Holding S.A.
SPNT	SiriusPoint Ltd.
ISDR	Issuer Direct Corporation
XGN	Exagen Inc.
ESE	ESCO Technologies Inc.
NICMF	Nickel Industries Limited
OCSL	Oaktree Specialty Lending Corporation
MNK	Mallinckrodt plc
LSAK	Lesaka Technologies, Inc.
VEEE	Twin Vee Powercats Co.
FDUS	Fidus Investment Corporation
LXFR	Luxfer Holdings PLC
AAMC	Altisource Asset Management Corporation
IMPM	Impac Mortgage Holdings, Inc.
WK	Workiva Inc.
MOBX	Mobix Labs, Inc.
VFC	V.F. Corporation
SARTF	Sartorius AG
NWN	Northwest Natural Holding Company
LZB	La-Z-Boy Incorporated
SLF	Sun Life Financial Inc.
CYRN	Cyren Ltd.
SQZZF	Serica Energy plc
AAWH	Ascend Wellness Holdings, Inc.
CVALF	Covalon Technologies Ltd.
MSGM	Motorsport Games Inc.
BIO	Bio-Rad Laboratories, Inc.
FE	FirstEnergy Corp.
VIAOY	VIA optronics AG
QTRHF	Quarterhill Inc.
EVK	Ever-Glory International Group, Inc.
BXMT	Blackstone Mortgage Trust, Inc.
RNSHF	Renishaw plc
VVPR	VivoPower International PLC
ESI	Element Solutions Inc
KRG	Kite Realty Group Trust
DMRC	Digimarc Corporation
NBR	Nabors Industries Ltd.
AR	Antero Resources Corporation
FPLSF	5N Plus Inc.
BRTX	BioRestorative Therapies, Inc.
XIACF	Xiaomi Corporation
PTVE	Pactiv Evergreen Inc.
KUKE	Kuke Music Holding Limited
MNHFF	Mayr-Melnhof Karton AG
BYCBF	Barry Callebaut AG
KBCSF	KBC Group N.V.
APLS	Apellis Pharmaceuticals, Inc.
BNPQF	BNP Paribas S.A.
RHI	Robert Half International Inc.
CLPR	Clipper Realty Inc.
NXPL	NextPlat Corp
AAT	American Assets Trust, Inc.
CALA	Calithera Biosciences, Inc.
WBA	Walgreens Boots Alliance, Inc.
NSC	Norfolk Southern Corporation
NSTG	NanoString Technologies, Inc.
HRI	Herc Holdings Inc.
UDIRF	United Internet AG
VLN	Valens Semiconductor Ltd.
VLNSF	Velan Inc.
UHAL	U-Haul Holding Company
MRRTY	Marfrig Global Foods S.A.
MIRM	Mirum Pharmaceuticals, Inc.
JBT	JBT Marel Corporation
NFE	New Fortress Energy Inc.
OPRA	Opera Limited
FORR	Forrester Research, Inc.
HUBS	HubSpot, Inc.
IMMR	Immersion Corporation
DNA	Ginkgo Bioworks Holdings, Inc.
KKR	KKR & Co. Inc.
FLIC	The First of Long Island Corporation
STGW	Stagwell Inc.
LII	Lennox International Inc.
VIRT	Virtu Financial, Inc.
CBDBY	Companhia Brasileira de Distribuição
CURI	CuriosityStream Inc.
CIVB	Civista Bancshares, Inc.
BDGSF	Bank of Georgia Group PLC
SNOA	Sonoma Pharmaceuticals, Inc.
CBAUF	Commonwealth Bank of Australia
CBTX	CBTX, Inc.
RARE	Ultragenyx Pharmaceutical Inc.
SGML	Sigma Lithium Corporation
MDLZ	Mondelez International, Inc.
AGO	Assured Guaranty Ltd.
CPSI	Computer Programs and Systems, Inc.
IMO	Imperial Oil Limited
STAF	Staffing 360 Solutions, Inc.
DEUZF	Deutz AG
MDV	Modiv Inc.
JET.NE	Global Crossing Airlines Group Inc.
BKYI	BIO-key International, Inc.
PAG	Penske Automotive Group, Inc.
ELVAF	Evolva Holding S.A.
SLVM	Sylvamo Corporation
ENTA	Enanta Pharmaceuticals, Inc.
SMLP	Summit Midstream Partners, LP
SCFLF	Schaeffler AG
BURBY	Burberry Group plc
ASUUY	ASUSTeK Computer Inc.
BDIMF	Black Diamond Group Limited
PCFBF	Pacific Basin Shipping Limited
CPRX	Catalyst Pharmaceuticals, Inc.
CVGI	Commercial Vehicle Group, Inc.
IGIC	International General Insurance Holdings Ltd.
CNVS	Cineverse Corp.
GSIT	GSI Technology, Inc.
BSET	Bassett Furniture Industries, Incorporated
KLRS	Kalaris Therapeutics Inc
IVTJF	Investec Group
MUX	McEwen Mining Inc.
PRCT	PROCEPT BioRobotics Corporation
S	SentinelOne, Inc.
HNNMY	H & M Hennes & Mauritz AB (publ)
PAGP	Plains GP Holdings, L.P.
CULP	Culp, Inc.
ESTA	Establishment Labs Holdings Inc.
KAOCF	Kao Corporation
SEAC	SeaChange International, Inc.
LBC	Luther Burbank Corporation
WLY	John Wiley & Sons, Inc.
SAR	Saratoga Investment Corp.
NSYS	Nortech Systems Incorporated
AULT	Ault Alliance, Inc.
QD	Qudian Inc.
KKOYF	Kesko Oyj
AKBLF	ALK-Abelló A/S
GPI	Group 1 Automotive, Inc.
WPP	WPP plc
VRNT	Verint Systems Inc.
CMLS	Cumulus Media Inc.
AFRM	Affirm Holdings, Inc.
ICLR	ICON Public Limited Company
NTRA	Natera, Inc.
SKM	SK Telecom Co.,Ltd
PGNY	Progyny, Inc.
GBNH	Greenbrook TMS Inc.
WFAFF	Wesfarmers Limited
SMGKF	Smiths Group plc
EDIT	Editas Medicine, Inc.
TOL	Toll Brothers, Inc.
OEC	Orion Engineered Carbons S.A.
YY	JOYY Inc.
TDS	Telephone and Data Systems, Inc.
ALTI	AlTi Global, Inc.
PBKOF	Pollard Banknote Limited
SRCL	Stericycle, Inc.
HPQ	HP Inc.
NNBR	NN, Inc.
FTAI	FTAI Aviation Ltd.
RYCEY	Rolls-Royce Holdings plc
SUPV	Grupo Supervielle S.A.
ASAI	Sendas Distribuidora S.A.
SHIP	Seanergy Maritime Holdings Corp.
LGIH	LGI Homes, Inc.
TLS	Telos Corporation
IBIO	iBio, Inc.
ALFVF	Alfa Laval Corporate AB
SKIL	Skillsoft Corp.
TWO	Two Harbors Investment Corp.
PRDO	Perdoceo Education Corporation
MKL	Markel Corporation
SNEX	StoneX Group Inc.
AINC	Ashford Inc.
KIND	Nextdoor Holdings, Inc.
MHIVF	Invesque Inc.
CSL	Carlisle Companies Incorporated
HCI	HCI Group, Inc.
KWHIY	Kawasaki Heavy Industries, Ltd.
HALL	Hallmark Financial Services, Inc.
CBUTF	Clear Blue Technologies International Inc.
UMC	United Microelectronics Corporation
WF	Woori Financial Group Inc.
CAVA	CAVA Group, Inc.
LESL	Leslie's, Inc.
ITVPF	ITV plc
AZZ	AZZ Inc.
NVZMF	Novozymes A/S
CAPR	Capricor Therapeutics, Inc.
TOUR	Tuniu Corporation
ALTO	Alto Ingredients, Inc.
MS	Morgan Stanley
BANC	Banc of California, Inc.
HI	Hillenbrand, Inc.
PLTK	Playtika Holding Corp.
RCRRF	Recruit Holdings Co., Ltd.
MRK	Merck & Co., Inc.
BN	Brookfield Corporation
BHC	Bausch Health Companies Inc.
UONE	Urban One, Inc.
VEL	Velocity Financial, Inc.
SSREF	Swiss Re AG
RYCEF	Rolls-Royce Holdings plc
FBIO	Fortress Biotech, Inc.
OPAL	OPAL Fuels Inc.
ULY	Urgent.ly Inc. Common Stock
QBTS	D-Wave Quantum Inc.
PKOH	Park-Ohio Holdings Corp.
KE	Kimball Electronics, Inc.
BOX	Box, Inc.
BSEM	BioStem Technologies, Inc.
EVTC	EVERTEC, Inc.
KVYO	Klaviyo, Inc.
TERRF	Terna - Rete Elettrica Nazionale Società per Azioni
VSEC	VSE Corporation
CBOE	Cboe Global Markets, Inc.
VOYJF	Valmet Oyj
PRDSY	Prada S.p.A.
DXLG	Destination XL Group, Inc.
JDHIF	JD Health International Inc.
FCX	Freeport-McMoRan Inc.
GENTF	G5 Entertainment AB (publ)
MWRK	MetaWorks Platforms, Inc.
WIRE	Encore Wire Corporation
BKFKF	P/F Bakkafrost
ARQT	Arcutis Biotherapeutics, Inc.
CLPBF	Coloplast A/S
ATOM	Atomera Incorporated
NEXPF	Nexi S.p.A.
COIHF	Croda International Plc
TCX	Tucows Inc.
MRAM	Everspin Technologies, Inc.
FNOXF	Fortnox AB (publ)
CTXXF	CEMATRIX Corporation
BLFY	Blue Foundry Bancorp
BDSX	Biodesix, Inc.
IQV	IQVIA Holdings Inc.
BGC	BGC Group, Inc
ABT	Abbott Laboratories
COR	Cencora, Inc.
VGPBF	Vgp N.V.
APH	Amphenol Corporation
TROX	Tronox Holdings plc
CMP	Compass Minerals International, Inc.
SCS	Steelcase Inc.
HLBZF	HeidelbergCement AG
CPXGF	Cineplex Inc.
UPS	United Parcel Service, Inc.
GMAN	Goldman Sachs Manufacturing Revolution ETF
AAP	Advance Auto Parts, Inc.
MONRF	Moncler S.p.A.
TPR	Tapestry, Inc.
PLZL.IL	PJSC Polyus
LNZNF	Lenzing AG
RYN	Rayonier Inc.
VST	Vistra Corp.
LYSFF	Lerøy Seafood Group ASA
FDX	FedEx Corporation
SDC	SmileDirectClub, Inc.
KT	KT Corporation
XHR	Xenia Hotels & Resorts, Inc.
MTN	Vail Resorts, Inc.
RDHL	RedHill Biopharma Ltd.
KNYJF	KONE Oyj
LGTY	Logility Supply Chain Solutions, Inc.
CCU	Compañía Cervecerías Unidas S.A.
MAKSF	Marks and Spencer Group plc
RNW	ReNew Energy Global Plc
KO	The Coca-Cola Company
JNCE	Jounce Therapeutics, Inc.
DRQ	Dril-Quip, Inc.
LBRDA	Liberty Broadband Corporation
HOEGF	Höegh Autoliners ASA
VMI	Valmont Industries, Inc.
BMA	Banco Macro S.A.
PARA	Paramount Global
SONM	Sonim Technologies, Inc.
BKTI	BK Technologies Corporation
NOMD	Nomad Foods Limited
DAC	Danaos Corporation
LPX	Louisiana-Pacific Corporation
CARS	Cars.com Inc.
YETI	YETI Holdings, Inc.
BMO	Bank of Montreal
MTDR	Matador Resources Company
ESAB	ESAB Corporation
STEC	Santech Holdings Limited
BCO	The Brink's Company
MBII	Marrone Bio Innovations, Inc.
BRC	Brady Corporation
KPELF	Keppel Corporation Limited
BOSC	B.O.S. Better Online Solutions Ltd.
MSFT	Microsoft Corporation
PUK	Prudential plc
CORBF	Global Cord Blood Corporation
TKR	The Timken Company
REXR	Rexford Industrial Realty, Inc.
MDVL	MedAvail Holdings, Inc.
YCBD	cbdMD, Inc.
YJ	Yunji Inc.
SMBMF	Sembcorp Marine Ltd
MATW	Matthews International Corporation
BDC	Belden Inc.
NUFMF	Nufarm Limited
ASTH	Astrana Health, Inc.
SHW	The Sherwin-Williams Company
SBH	Sally Beauty Holdings, Inc.
EGY	VAALCO Energy, Inc.
SMFKY	Smurfit Kappa Group Plc
PPG	PPG Industries, Inc.
YELLQ	Yellow Corporation
ADX	Adams Diversified Equity Fund, Inc.
MP	MP Materials Corp.
ATEN	A10 Networks, Inc.
SR	Spire Inc.
CTSO	Cytosorbents Corporation
CDXC	ChromaDex Corporation
ADMA	ADMA Biologics, Inc.
MRKR	Marker Therapeutics, Inc.
GMGI	Golden Matrix Group, Inc.
USER	UserTesting, Inc.
DECK	Deckers Outdoor Corporation
RAASY	Cloopen Group Holding Limited
ARNA	Arena Pharmaceuticals, Inc.
DDCCF	Branicks Group AG
FLOOF	Flower One Holdings Inc.
CSPI	CSP Inc.
XNET	Xunlei Limited
SHG	Shinhan Financial Group Co., Ltd.
EONR	EON Resources Inc.
POCI	Precision Optics Corporation, Inc.
MSI	Motorola Solutions, Inc.
PAM	Pampa Energía S.A.
LKNCY	Luckin Coffee Inc.
DYNDF	Dye & Durham Limited
NBHC	National Bank Holdings Corporation
UIS	Unisys Corporation
NOV	NOV Inc.
CLSK	CleanSpark, Inc.
NOW	ServiceNow, Inc.
HCC	Warrior Met Coal, Inc.
OC	Owens Corning
NNGPF	NN Group N.V.
PATH	UiPath Inc.
PB	Prosperity Bancshares, Inc.
PLYM	Plymouth Industrial REIT, Inc.
OSUR	OraSure Technologies, Inc.
PRKS	United Parks & Resorts Inc.
MEGEF	MEG Energy Corp.
BCS	Barclays PLC
SGSOF	Sgs S.A.
AMTX	Aemetis, Inc.
DAL	Delta Air Lines, Inc.
STIM	Neuronetics, Inc.
PRMB	Primo Brands Corporation
ELDN	Eledon Pharmaceuticals, Inc.
SDVKF	Sandvik AB (publ)
ASC	Ardmore Shipping Corporation
ANSS	ANSYS, Inc.
ENGIY	Engie S.A.
PVH	PVH Corp.
LAD	Lithia Motors, Inc.
SLNG	Stabilis Solutions, Inc.
AUID	authID Inc.
STKH	Steakholder Foods Ltd.
CMTG	Claros Mortgage Trust, Inc.
QUAD	Quad/Graphics, Inc.
GLRE	Greenlight Capital Re, Ltd.
JSNSF	J Sainsbury plc
CGJTF	Cargojet Inc.
HOYFF	Huhtamäki Oyj
GWB	Great Western Bancorp, Inc.
HP	Helmerich & Payne, Inc.
CTLT	Catalent, Inc.
SUZ	Suzano S.A.
SEMG	EA Series Trust
ENZ	Enzo Biochem, Inc.
BRG	Bluerock Residential Growth REIT, Inc.
REMYF	Rémy Cointreau S.A.
BSBR	Banco Santander (Brasil) S.A.
HTHT	H World Group Limited
ALAR	Alarum Technologies Ltd.
CANF	Can-Fite BioPharma Ltd.
DTC	Solo Brands, Inc.
ANYYY	Aena S.M.E., S.A.
PDS	Precision Drilling Corporation
EBS	Emergent BioSolutions Inc.
HEINY	Heineken N.V.
TCNNF	Trulieve Cannabis Corp.
SHOP	Shopify Inc.
ONTTF	Oxford Nanopore Technologies plc
EXPRQ	Express, Inc.
ITW	Illinois Tool Works Inc.
NILSY	PJSC Mining and Metallurgical Company Norilsk Nickel
RL	Ralph Lauren Corporation
TLLTF	TILT Holdings Inc.
EVH	Evolent Health, Inc.
PKE	Park Aerospace Corp.
PMREF	Primaris Real Estate Investment Trust
BRCNF	Burcon NutraScience Corporation
STWD	Starwood Property Trust, Inc.
BYON	Beyond, Inc.
CVSI	CV Sciences, Inc.
ASBFY	Associated British Foods plc
PEG	Public Service Enterprise Group Incorporated
SNMRF	Snam S.p.A.
CIVI	Civitas Resources, Inc.
MCY	Mercury General Corporation
RXRX	Recursion Pharmaceuticals, Inc.
SXI	Standex International Corporation
DNMR	Danimer Scientific, Inc.
TGLS	Tecnoglass Inc.
TBIO	Telesis Bio, Inc.
TNON	Tenon Medical, Inc.
LRLCF	L'Oréal S.A.
TTI	TETRA Technologies, Inc.
UNF	UniFirst Corporation
TNTFF	PostNL N.V.
NGL	NGL Energy Partners LP
EC	Ecopetrol S.A.
SIVB	SVB Financial Group
USPH	U.S. Physical Therapy, Inc.
WPC	W. P. Carey Inc.
USEG	U.S. Energy Corp.
OIBZQ	Oi S.A.
ETON	Eton Pharmaceuticals, Inc.
BRP	BRP Group, Inc.
BRPHF	Galaxy Digital Holdings Ltd.
AMTD	AMTD IDEA Group
VVV	Valvoline Inc.
KORE	KORE Group Holdings, Inc.
SJM	The J. M. Smucker Company
GBNXF	Gibson Energy Inc.
TGI	Triumph Group, Inc.
NAVI	Navient Corporation
RERE	ATRenew Inc.
TATLY	Tata Steel Limited
VZ	Verizon Communications Inc.
AZN	AstraZeneca PLC
TGP	Teekay LNG Partners L.P.
SSRM	SSR Mining Inc.
WMB	The Williams Companies, Inc.
TEUM	Pareteum Corporation
VRNOF	Verano Holdings Corp.
RLI	RLI Corp.
XYZ	Block, Inc.
PKIUF	Parkland Corporation
AMCR	Amcor plc
RNSDF	Renault S.A.
ITPOF	Intertape Polymer Group Inc.
SLGN	Silgan Holdings Inc.
BMBL	Bumble Inc.
EXK	Endeavour Silver Corp.
GVDBF	Givaudan S.A.
KODK	Eastman Kodak Company
ARMK	Aramark
FARO	FARO Technologies, Inc.
ML	MoneyLion Inc.
601628.SS	China Life Insurance Company Limited
ACOG	Alpha Cognition Inc. Common Stock
AXON	Axon Enterprise, Inc.
AXS	AXIS Capital Holdings Limited
CIXX	CI Financial Corp.
CTHR	Charles & Colvard, Ltd.
SIBN	SI-BONE, Inc.
BGSF	BGSF, Inc.
BHVN	Biohaven Ltd.
DK	Delek US Holdings, Inc.
TER	Teradyne, Inc.
BATL	Battalion Oil Corporation
TTOO	T2 Biosystems, Inc.
TYNPF	Nippon Sanso Holdings Corporation
JBSS	John B. Sanfilippo & Son, Inc.
RIGL	Rigel Pharmaceuticals, Inc.
COLL	Collegium Pharmaceutical, Inc.
TRVG	trivago N.V.
BPIRY	Piraeus Financial Holdings S.A.
TNC	Tennant Company
BRFS	Brf S.a.
KMERF	Komercní banka, a.s.
DXYN	The Dixie Group, Inc.
BVS	Bioventus Inc.
BWFG	Bankwell Financial Group, Inc.
SIG	Signet Jewelers Limited
SACH	Sachem Capital Corp.
SFUN	Fang Holdings Limited
CDW	CDW Corporation
CFG	Citizens Financial Group, Inc.
TTEC	TTEC Holdings, Inc.
CAAP	Corporación América Airports S.A.
IDT	IDT Corporation
AEXAF	Atos SE
CHUY	Chuy's Holdings, Inc.
HGTY	Hagerty, Inc.
CMC	Commercial Metals Company
MEDS	TRxADE HEALTH, Inc.
DSP	Viant Technology Inc.
LXRX	Lexicon Pharmaceuticals, Inc.
DY	Dycom Industries, Inc.
ECL	Ecolab Inc.
FNNNF	Finnair Oyj
SUPN	Supernus Pharmaceuticals, Inc.
MSBI	Midland States Bancorp, Inc.
HUSQF	Husqvarna AB (publ)
CGAU	Centerra Gold Inc.
PHPRF	Primary Health Properties PLC
TASK	TaskUs, Inc.
PHLT	Performant Healthcare, Inc.
TBPH	Theravance Biopharma, Inc.
ATS	ATS Corporation
YARIY	Yara International ASA
BTBT	Bit Digital, Inc.
MAXN	Maxeon Solar Technologies, Ltd.
SAIA	Saia, Inc.
REYN	Reynolds Consumer Products Inc.
HZNP	Horizon Therapeutics Public Limited Company
ENS	EnerSys
HES	Hess Corporation
VERU	Veru Inc.
EGLX	Enthusiast Gaming Holdings Inc.
ERJ	Embraer S.A.
HQI	HireQuest, Inc.
FET	Forum Energy Technologies, Inc.
CDE	Coeur Mining, Inc.
CINR	Sisecam Resources LP
GOGL	Golden Ocean Group Limited
MTG	MGIC Investment Corporation
RTO	Rentokil Initial plc
NR	Newpark Resources, Inc.
LYFT	Lyft, Inc.
FLS	Flowserve Corporation
BZ	Kanzhun Limited
AGL	Agilon Health, Inc.
IDXG	Interpace Biosciences, Inc.
TCON	TRACON Pharmaceuticals, Inc.
ATY	AcuityAds Holdings Inc.
BYND	Beyond Meat, Inc.
XAIR	Beyond Air, Inc.
STRA	Strategic Education, Inc.
TNISF	Técnicas Reunidas, S.A.
FULT	Fulton Financial Corporation
SENS	Senseonics Holdings, Inc.
WTKWY	Wolters Kluwer N.V.
GLPG	Galapagos N.V.
FNLPF	Fresnillo plc
WILLF	Demant A/S
LNG	Cheniere Energy, Inc.
ZDGE	Zedge, Inc.
IMBBY	Imperial Brands PLC
IRWD	Ironwood Pharmaceuticals, Inc.
GEF	Greif, Inc.
MBOT	Microbot Medical Inc.
EMLAF	Empire Company Limited
GFF	Griffon Corporation
GLW	Corning Incorporated
ALCO	Alico, Inc.
NWHUF	NorthWest Healthcare Properties Real Estate Investment Trust
GOOS	Canada Goose Holdings Inc.
HLI	Houlihan Lokey, Inc.
GWRE	Guidewire Software, Inc.
HLLY	Holley Inc.
IVSXF	Investor AB (publ)
GPS	The Gap, Inc.
CNP	CenterPoint Energy, Inc.
ELOX	Eloxx Pharmaceuticals, Inc.
VERB	Verb Technology Company, Inc.
KRNNF	Krones AG
HPE	Hewlett Packard Enterprise Company
HRB	H&R Block, Inc.
WTBA	West Bancorporation, Inc.
GS	The Goldman Sachs Group, Inc.
HUBB	Hubbell Incorporated
UDR	UDR, Inc.
DHC	Diversified Healthcare Trust
ACAD	ACADIA Pharmaceuticals Inc.
C	Citigroup Inc.
POR	Portland General Electric Company
IP	International Paper Company
KD	Kyndryl Holdings, Inc.
DAN	Dana Incorporated
EDAP	Edap Tms S.a.
VEOEY	Veolia Environnement S.A.
GRAB	Grab Holdings Limited
ENG	ENGlobal Corporation
RGS	Regis Corporation
KEY	KeyCorp
TRV	The Travelers Companies, Inc.
AUPH	Aurinia Pharmaceuticals Inc.
FUPBY	Fuchs Petrolub SE
LHX	L3Harris Technologies, Inc.
LOW	Lowe's Companies, Inc.
IONM	Assure Holdings Corp.
ACI	Albertsons Companies, Inc.
MDWD	MediWound Ltd.
IDEX	Ideanomics, Inc.
TEO	Telecom Argentina S.A.
WM	Waste Management, Inc.
ACR	ACRES Commercial Realty Corp.
MG	Mistras Group, Inc.
MFC	Manulife Financial Corporation
THRY	Thryv Holdings, Inc.
AHR	American Healthcare REIT, Inc.
AG	First Majestic Silver Corp.
OFG	OFG Bancorp
CEPU	Central Puerto S.A.
ALG	Alamo Group Inc.
UMH	UMH Properties, Inc.
SKYH	Sky Harbour Group Corporation
AIR	AAR Corp.
SRE	Sempra
AIT	Applied Industrial Technologies, Inc.
BNL	Broadstone Net Lease, Inc.
MMS	Maximus, Inc.
MRETF	Martinrea International Inc.
PBI	Pitney Bowes Inc.
ETSY	Etsy, Inc.
UPLD	Upland Software, Inc.
ORINF	Orion Oyj
ZS	Zscaler, Inc.
APAM	Artisan Partners Asset Management Inc.
RNFTF	PJSC Rosneft Oil Company
SGU	Star Group, L.P.
HAS	Hasbro, Inc.
NVT	nVent Electric plc
CCS	Century Communities, Inc.
YTRA	Yatra Online, Inc.
BCE	BCE Inc.
ABR	Arbor Realty Trust, Inc.
NTRP	NextTrip, Inc.
LAB	Standard BioTools Inc.
SU	Suncor Energy Inc.
FER	Ferrovial SE
SWSDF	Swiss Life Holding AG
AKYA	Akoya Biosciences, Inc.
DTI	Drilling Tools International Corp.
KIRK	Kirkland's, Inc.
ADM	Archer-Daniels-Midland Company
PDM	Piedmont Office Realty Trust, Inc.
HY	Hyster-Yale Materials Handling, Inc.
VSAT	Viasat, Inc.
RELL	Richardson Electronics, Ltd.
HUM	Humana Inc.
TIMB	Tim S.a.
BBLN	Babylon Holdings Limited
RSI	Rush Street Interactive, Inc.
BJWTF	Beijing Enterprises Water Group Limited
KMT	Kennametal Inc.
JPM	JPMorgan Chase & Co.
SKY	Skyline Champion Corporation
BBD	Banco Bradesco S.A.
GLP	Global Partners LP
COMP	Compass, Inc.
PDD	PDD Holdings Inc.
AY	Atlantica Sustainable Infrastructure plc
DCBO	Docebo Inc.
AXNX	Axonics, Inc.
ALSN	Allison Transmission Holdings, Inc.
BNGO	Bionano Genomics, Inc.
BZFD	BuzzFeed, Inc.
EVGO	EVgo, Inc.
FLUIF	Fluidra, S.A.
NSSC	Napco Security Technologies, Inc.
WRTBF	Wärtsilä Oyj Abp
TLSNF	Telia Company AB (publ)
ABM	ABM Industries Incorporated
PUMSY	PUMA Se
PCYG	Park City Group, Inc.
KMPR	Kemper Corporation
ACGBY	Agricultural Bank of China Limited
GOVX	GeoVax Labs, Inc.
JOUT	Johnson Outdoors Inc.
BRY	Berry Corporation
UCB	United Community Banks, Inc.
USAC	USA Compression Partners, LP
INTZ	Intrusion Inc.
ACIC	American Coastal Insurance Corporation
XOMA	XOMA Royalty Corp.
AGX	Argan, Inc.
ENSV	Enservco Corporation
CGECF	Cogeco Inc.
PLUG	Plug Power Inc.
RBB	RBB Bancorp
PEN	Penumbra, Inc.
LASE	Laser Photonics Corporation
SSTK	Shutterstock, Inc.
IRMD	IRadimed Corporation
YRD	Yiren Digital Ltd.
CPST	Calamos S&P 500 Structured Alt Protection ETF - September
CVEO	Civeo Corporation
AAFRF	Airtel Africa Plc
DPRO	Draganfly Inc.
MMI	Marcus & Millichap, Inc.
RESI	Kelly Residential & Apartment Real Estate ETF
TXMD	TherapeuticsMD, Inc.
HROW	Harrow Health, Inc.
DRCT	Direct Digital Holdings, Inc.
DG	Dollar General Corporation
NBIX	Neurocrine Biosciences, Inc.
SE	Sea Limited
RYI	Ryerson Holding Corporation
WRK	WestRock Company
OGS	ONE Gas, Inc.
CRON	Cronos Group Inc.
RAMP	LiveRamp Holdings, Inc.
CBT	Cabot Corporation
ARBK	Argo Blockchain plc
PJT	PJT Partners Inc.
AGLNF	AGL Energy Limited
SURG	SurgePays, Inc.
AXP	American Express Company
ATVI	Activision Blizzard, Inc.
ALOT	AstroNova, Inc.
ANNSF	Aena S.M.E., S.A.
RVTY	Revvity, Inc.
TGE	The Generation Essentials Group
PAIOF	Paion AG
DELL	Dell Technologies Inc.
RSGUF	Rogers Sugar Inc.
TTNP	Titan Pharmaceuticals, Inc.
FGPR	Ferrellgas Partners, L.P.
DXCM	DexCom, Inc.
BIOR	Biora Therapeutics, Inc.
XIN	Xinyuan Real Estate Co., Ltd.
BZLFF	Bunzl plc
EFX	Equifax Inc.
OMI	Owens & Minor, Inc.
VRME	VerifyMe, Inc.
TELNF	Telenor ASA
EKTAF	Elekta AB (publ)
FOSL	Fossil Group, Inc.
CVX	Chevron Corporation
SWK	Stanley Black & Decker, Inc.
CBWTF	Auxly Cannabis Group Inc.
IQ	iQIYI, Inc.
CBSTF	The Cannabist Company Holdings Inc.
TAK	Takeda Pharmaceutical Company Limited
NU	Nu Holdings Ltd.
ONTO	Onto Innovation Inc.
PD	PagerDuty, Inc.
CNSL	Consolidated Communications Holdings, Inc.
APYX	Apyx Medical Corporation
GT	The Goodyear Tire & Rubber Company
PIPR	Piper Sandler Companies
OXY	Occidental Petroleum Corporation
AKTS	Akoustis Technologies, Inc.
VNRFY	Vienna Insurance Group AG
DM	Desktop Metal, Inc.
INMD	InMode Ltd.
EDNMF	Edenred S.A.
PII	Polaris Inc.
PLOW	Douglas Dynamics, Inc.
PTEN	Patterson-UTI Energy, Inc.
PNR	Pentair plc
TME	Tencent Music Entertainment Group
SLB	Schlumberger Limited
DKS	DICK'S Sporting Goods, Inc.
HBB	Hamilton Beach Brands Holding Company
GIB	CGI Inc.
SNX	TD SYNNEX Corporation
QTWO	Q2 Holdings, Inc.
SPB	Spectrum Brands Holdings, Inc.
CGBD	Carlyle Secured Lending, Inc.
HRTH	Harte Hanks, Inc.
LQMT	Liquidmetal Technologies, Inc.
VEDL	Vedanta Limited
TMO	Thermo Fisher Scientific Inc.
TSN	Tyson Foods, Inc.
IDN	Intellicheck, Inc.
FSK	FS KKR Capital Corp.
UBSI	United Bankshares, Inc.
WEN	The Wendy's Company
HOV	Hovnanian Enterprises, Inc.
MAT	Mattel, Inc.
AACG	ATA Creativity Global
CCM	Concord Medical Services Holdings Limited
VEEV	Veeva Systems Inc.
RELI	Reliance Global Group, Inc.
VIST	Vista Energy, S.A.B. de C.V.
TROW	T. Rowe Price Group, Inc.
ABSSF	AirBoss of America Corp.
WOR	Worthington Industries, Inc.
TTC	The Toro Company
VTRS	Viatris Inc.
NUS	Nu Skin Enterprises, Inc.
BACHF	Bank of China Limited
WWW	Wolverine World Wide, Inc.
MOGO	Mogo Inc.
HMN	Horace Mann Educators Corporation
CTKB	Cytek Biosciences, Inc.
TSHA	Taysha Gene Therapies, Inc.
PETS	PetMed Express, Inc.
MOV	Movado Group, Inc.
AMTM	Amentum Holdings, Inc.
LBTSF	Almirall, S.A.
ARHS	Arhaus, Inc.
MCW	Mister Car Wash, Inc.
BNED	Barnes & Noble Education, Inc.
PGPHF	Partners Group Holding AG
PHIO	Phio Pharmaceuticals Corp.
LE	Lands' End, Inc.
BKCYF	Bank of Cyprus Holdings Public Limited Company
GTIM	Good Times Restaurants Inc.
TEF	Telefónica, S.A.
KGC	Kinross Gold Corporation
AKU	Akumin Inc.
BKU	BankUnited, Inc.
ATIP	ATI Physical Therapy, Inc.
AU	AngloGold Ashanti Plc
DOW	Dow Inc.
BPCGF	Banco Comercial Português, S.A.
XYL	Xylem Inc.
ATRC	AtriCure, Inc.
BAC	Bank of America Corporation
GOOD	Gladstone Commercial Corporation
VEON	VEON Ltd.
SNN	Smith & Nephew plc
OMH	Ohmyhome Limited
TENX	Tenax Therapeutics, Inc.
UPXI	Upexi, Inc.
NEMTF	Nemetschek SE
HWAIF	Healwell AI Inc.
NPCE	NeuroPace, Inc.
VIA	Via Renewables, Inc.
PDCO	Patterson Companies, Inc.
FRZA	Forza X1, Inc.
VEXTF	Vext Science, Inc.
RICK	RCI Hospitality Holdings, Inc.
OPTT	Ocean Power Technologies, Inc.
PFHD	Professional Holding Corp.
AEMD	Aethlon Medical, Inc.
CPB	Campbell Soup Company
CNDT	Conduent Incorporated
SECCF	Serco Group plc
ROIUF	Route1 Inc.
OTLY	Oatly Group AB
AXTA	Axalta Coating Systems Ltd.
BLD	TopBuild Corp.
JNPR	Juniper Networks, Inc.
ESPR	Esperion Therapeutics, Inc.
GHG	GreenTree Hospitality Group Ltd.
BRX	Brixmor Property Group Inc.
SMSI	Smith Micro Software, Inc.
CURN	Currency Exchange International, Corp.
CAT	Caterpillar Inc.
CBRL	Cracker Barrel Old Country Store, Inc.
XEL	Xcel Energy Inc.
AUDAQ	Audacy, Inc.
SCTL	Societal CDMO, Inc.
STEM	Stem, Inc.
DUOT	Duos Technologies Group, Inc.
CNS	Cohen & Steers, Inc.
LMPX	LMP Automotive Holdings, Inc.
POELF	The Navigator Company, S.A.
CLF	Cleveland-Cliffs Inc.
SUN	Sunoco LP
GEOS	Geospace Technologies Corporation
MYNA	Mynaric AG
PKKFF	Tenet Fintech Group Inc.
CNQ	Canadian Natural Resources Limited
CPF	Central Pacific Financial Corp.
DBOEY	Deutsche Börse AG
LH	Labcorp Holdings Inc.
BKH	Black Hills Corporation
APEN	Apollo Endosurgery, Inc.
AEMMF	A2A S.p.A.
EWBC	East West Bancorp, Inc.
RY	Royal Bank of Canada
PFSW	PFSweb, Inc.
DBRG	DigitalBridge Group, Inc.
RWLK	ReWalk Robotics Ltd.
PYYX	Pyxus International, Inc.
MLR	Miller Industries, Inc.
SILC	Silicom Ltd.
CHGG	Chegg, Inc.
FTI	TechnipFMC plc
NBTX	Nanobiotix S.A.
DE	Deere & Company
FHN	First Horizon Corporation
EIGR	Eiger BioPharmaceuticals, Inc.
CMCO	Columbus McKinnon Corporation
BBIG	Vinco Ventures, Inc.
ENFY	Enlightify Inc.
SOUN	SoundHound AI, Inc.
WE	WeWork Inc.
SNDA	Sonida Senior Living, Inc.
MDLY	Medley Management Inc.
EQBK	Equity Bancshares, Inc.
CHX	ChampionX Corporation
CIR	CIRCOR International, Inc.
PSNL	Personalis, Inc.
DNNGY	Ørsted A/S
ESTC	Elastic N.V.
KLNG	Koil Energy Solutions, Inc.
FAF	First American Financial Corporation
UAMY	United States Antimony Corporation
ZEVY	Lightning eMotors, Inc.
EXLS	ExlService Holdings, Inc.
DSS	DSS, Inc.
DAKT	Daktronics, Inc.
LDI	loanDepot, Inc.
CRCT	Cricut, Inc.
KRC	Kilroy Realty Corporation
KFS	Kingsway Financial Services Inc.
GAIN	Gladstone Investment Corporation
IMH	Impac Mortgage Holdings, Inc.
FLGT	Fulgent Genetics, Inc.
BY	Byline Bancorp, Inc.
QCOM	QUALCOMM Incorporated
ELYS	Elys BMG Group, Inc.
SNPS	Synopsys, Inc.
VIOT	Viomi Technology Co., Ltd
SFT	Shift Technologies, Inc.
ONVO	Organovo Holdings, Inc.
KMTUY	Komatsu Ltd.
LGND	Ligand Pharmaceuticals Incorporated
BWLKF	Boardwalktech Software Corp.
MEG	Montrose Environmental Group, Inc.
ACV	Virtus Diversified Income & Convertible Fund
MLM	Martin Marietta Materials, Inc.
ALC	Alcon Inc.
ICBK	County Bancorp, Inc.
PFSI	PennyMac Financial Services, Inc.
BX	Blackstone Inc.
NLY	Annaly Capital Management, Inc.
BLSFF	BlueScope Steel Limited
BG	Bunge Global S.A.
MC	Moelis & Company
EXP	Eagle Materials Inc.
PYNKF	Perimeter Medical Imaging AI, Inc.
WKHS	Workhorse Group Inc.
BQSSF	Boss Energy Limited
DIN	Dine Brands Global, Inc.
CLPT	ClearPoint Neuro, Inc.
PRLB	Proto Labs, Inc.
MBXBF	Microbix Biosystems Inc.
CHRW	C.H. Robinson Worldwide, Inc.
DALN	DallasNews Corporation
ESMT	EngageSmart, Inc.
BBSEY	BB Seguridade Participações S.A.
LKCO	Luokung Technology Corp.
FLOC	Flowco Holdings Inc.
CAL	Caleres, Inc.
EAT	Brinker International, Inc.
JBTM	JBT Marel Corporation
YUMC	Yum China Holdings, Inc.
FNKO	Funko, Inc.
JWN	Nordstrom, Inc.
HEXO	HEXO Corp.
R	Ryder System, Inc.
LDWY	Lendway, Inc.
IMGN	ImmunoGen, Inc.
KYYWF	Keywords Studios plc
ULTR	IQ Ultra Short Duration ETF
TREX	Trex Company, Inc.
LGO	Largo Inc.
IBKR	Interactive Brokers Group, Inc.
INVO	INVO Bioscience, Inc.
PSN	Parsons Corporation
MUSA	Murphy USA Inc.
UNM	Unum Group
JRSH	Jerash Holdings (US), Inc.
BILL	Bill.com Holdings, Inc.
NPO	EnPro Industries, Inc.
ATXS	Astria Therapeutics, Inc.
OB	Outbrain Inc.
TDC	Teradata Corporation
ALEC	Alector, Inc.
TWMIF	Tidewater Midstream and Infrastructure Ltd.
MTBLY	Moatable, Inc.
NATL	NCR Atleos Corporation
CLS	Celestica Inc.
OUTFF	Outokumpu Oyj
ACTG	Acacia Research Corporation
ACA	Arcosa, Inc.
CTO	CTO Realty Growth, Inc.
CWAN	Clearwater Analytics Holdings, Inc.
FLNC	Fluence Energy, Inc.
DX	Dynex Capital, Inc.
BEP	Brookfield Renewable Partners L.P.
WPLCF	Wise plc
SEG	Seaport Entertainment Group Inc.
VIASP	Via Renewables, Inc.
JCDXF	JCDecaux SE
LFUS	Littelfuse, Inc.
AVNT	Avient Corporation
SD	SandRidge Energy, Inc.
DHI	D.R. Horton, Inc.
VLVLY	AB Volvo (publ)
MSGE	Madison Square Garden Entertainment Corp.
YEXT	Yext, Inc.
GROY	Gold Royalty Corp.
TM	Toyota Motor Corporation
MCRB	Seres Therapeutics, Inc.
SPTN	SpartanNash Company
MPX	Marine Products Corporation
HCA	HCA Healthcare, Inc.
ASAPQ	Waitr Holdings Inc.
PWSC	PowerSchool Holdings, Inc.
LOCL	Local Bounti Corporation
TRP	TC Energy Corporation
ARCH	Arch Resources, Inc.
NLLSF	Nel ASA
JRONY	Jerónimo Martins, SGPS, S.A.
RMR	The RMR Group Inc.
NRDY	Nerdy, Inc.
IEX	IDEX Corporation
SCPL	SciPlay Corporation
MNSB	MainStreet Bancshares, Inc.
BSFFF	Basic-Fit N.V.
SRI	Stoneridge, Inc.
CDMO	Avid Bioservices, Inc.
FLWS	1-800-FLOWERS.COM, Inc.
CBAN	Colony Bankcorp, Inc.
YPF	YPF Sociedad Anónima
ASRT	Assertio Holdings, Inc.
LGRVF	Legrand S.A.
IMPL	Impel Pharmaceuticals Inc.
CCLD	CareCloud, Inc.
INT	World Fuel Services Corporation
MSP	Datto Holding Corp.
BB	BlackBerry Limited
PIFYF	Pine Cliff Energy Ltd.
NSP	Insperity, Inc.
SFNC	Simmons First National Corporation
HCM	HUTCHMED (China) Limited
CPNG	Coupang, Inc.
AVAV	AeroVironment, Inc.
STRR	Star Equity Holdings, Inc.
PYR	PyroGenesis Canada Inc.
FTS	Fortis Inc.
EPD	Enterprise Products Partners L.P.
UFI	Unifi, Inc.
LKQ	LKQ Corporation
BMRRY	B&M European Value Retail S.A.
SW	Smurfit Westrock Plc
SSSS	SuRo Capital Corp.
CPSS	Consumer Portfolio Services, Inc.
MDALF	MDA Ltd.
IRNT	IronNet, Inc.
BUFF	Innovator Laddered Allocation Power Buffer ETF
TLPPF	Telix Pharmaceuticals Limited
DLX	Deluxe Corporation
NVST	Envista Holdings Corp
ECG	Everus Construction Group, Inc.
MSGS	Madison Square Garden Sports Corp.
GPOR	Gulfport Energy Corporation
REGN	Regeneron Pharmaceuticals, Inc.
SEGXF	SEGRO Plc
MTD	Mettler-Toledo International Inc.
BHST	BioHarvest Sciences Inc. Common Stock
NX	Quanex Building Products Corporation
NN	NextNav Inc.
CLNXF	Cellnex Telecom, S.A.
NXGL	NEXGEL, Inc.
SVCBF	Svenska Cellulosa Aktiebolaget SCA (publ)
BASE	Couchbase, Inc.
PNGAY	Ping An Insurance (Group) Company of China, Ltd.
ETRN	Equitrans Midstream Corporation
ENGGF	Enagás, S.A.
EXE	Expand Energy Corporation
OCGN	Ocugen, Inc.
NC	NACCO Industries, Inc.
VAPO	Vapotherm, Inc.
EDBL	Edible Garden AG Incorporated
NUE	Nucor Corporation
NVS	Novartis AG
MFIN	Medallion Financial Corp.
MURGY	Münchener Rückversicherungs-Gesellschaft AG in München
HLFFF	HelloFresh SE
LMNR	Limoneira Company
NMIH	NMI Holdings, Inc.
OMC	Omnicom Group Inc.
MITT	AG Mortgage Investment Trust, Inc.
HLGN	Heliogen, Inc.
PSX	Phillips 66
SARO	StandardAero, Inc.
REX	REX American Resources Corporation
YELL	Yellow Corporation
SBNY	Signature Bank
RLJ	RLJ Lodging Trust
SLG	SL Green Realty Corp.
BRZE	Braze, Inc.
INKT	MiNK Therapeutics, Inc.
COLB	Columbia Banking System, Inc.
HMST	HomeStreet, Inc.
DOCN	DigitalOcean Holdings, Inc.
RPM	RPM International Inc.
UAVS	AgEagle Aerial Systems, Inc.
FOA	Finance Of America Companies Inc.
TA	TravelCenters of America Inc.
SAP	Sap Se
SITE	SiteOne Landscape Supply, Inc.
SMP	Standard Motor Products, Inc.
PFMT	Performant Financial Corporation
SNAP	Snap Inc.
JAN	JanOne Inc.
SPOT	Spotify Technology S.A.
AVCTF	Avacta Group Plc
KRMD	KORU Medical Systems, Inc.
AZYO	Aziyo Biologics, Inc.
ST	Sensata Technologies Holding plc
TDW	Tidewater Inc.
ICMB	Investcorp Credit Management BDC, Inc.
TFII	TFI International Inc.
ALB	Albemarle Corporation
GRCLF	GrainCorp Limited
EEFT	Euronet Worldwide, Inc.
LFWD	ReWalk Robotics Ltd.
EH	EHang Holdings Limited
SMBK	SmartFinancial, Inc.
RDI	Reading International, Inc.
NXE	NexGen Energy Ltd.
MSBHF	Mitsubishi Corporation
DB	Deutsche Bank AG
INLB	Item 9 Labs Corp.
REI	Ring Energy, Inc.
AKAAF	Aker ASA
FUNFF	FansUnite Entertainment Inc.
GNK	Genco Shipping & Trading Limited
TNET	TriNet Group, Inc.
KVHI	KVH Industries, Inc.
JCAP	Jefferson Capital, Inc. Common Stock
EXAI	Exscientia plc
TOTZF	Total Energy Services Inc.
PLTR	Palantir Technologies Inc.
CLVT	Clarivate Plc
VVOS	Vivos Therapeutics, Inc.
SF	Stifel Financial Corp.
TACT	TransAct Technologies Incorporated
HEI	HEICO Corporation
TPCS	TechPrecision Corporation
TPVG	TriplePoint Venture Growth BDC Corp.
MTUS	Metallus Inc.
LMFA	LM Funding America, Inc.
UGP	Ultrapar Participações S.A.
TLF	Tandy Leather Factory, Inc.
CRLBF	Cresco Labs Inc.
TOI	The Oncology Institute, Inc.
BRO	Brown & Brown, Inc.
FULC	Fulcrum Therapeutics, Inc.
USNA	USANA Health Sciences, Inc.
UTI	Universal Technical Institute, Inc.
MFG	Mizuho Financial Group, Inc.
ARLP	Alliance Resource Partners, L.P.
HURN	Huron Consulting Group Inc.
EQRX	EQRx, Inc.
VNO	Vornado Realty Trust
CM	Canadian Imperial Bank of Commerce
AIFU	AIX Inc.
HSY	The Hershey Company
ZTS	Zoetis Inc.
HUYA	HUYA Inc.
TSYHY	TravelSky Technology Limited
IBN	ICICI Bank Limited
XPOF	Xponential Fitness, Inc.
ZBH	Zimmer Biomet Holdings, Inc.
J	Jacobs Engineering Group Inc.
LANV	Lanvin Group Holdings Limited
ALRM	Alarm.com Holdings, Inc.
RPID	Rapid Micro Biosystems, Inc.
AMTB	Amerant Bancorp Inc.
FMX	Fomento Económico Mexicano, S.A.B. de C.V.
LANC	Lancaster Colony Corporation
AON	Aon plc
VIVE	Viveve Medical, Inc.
WEWKQ	WeWork Inc.
SUI	Sun Communities, Inc.
UBER	Uber Technologies, Inc.
SPNE	SeaSpine Holdings Corporation
EPOKY	Epiroc AB (publ)
ARLO	Arlo Technologies, Inc.
ATGE	Adtalem Global Education Inc.
NTTYY	Nippon Telegraph and Telephone Corporation
CBAT	CBAK Energy Technology, Inc.
WES	Western Midstream Partners, LP
JAPAY	Japan Tobacco Inc.
AAPL	Apple Inc.
DLB	Dolby Laboratories, Inc.
TLPFF	Teleperformance SE
CAC	Camden National Corporation
CCK	Crown Holdings, Inc.
CDNA	CareDx, Inc
LFMD	LifeMD, Inc.
CL	Colgate-Palmolive Company
CHH	Choice Hotels International, Inc.
CIEN	Ciena Corporation
HGBL	Heritage Global Inc.
TMST	TimkenSteel Corporation
DGX	Quest Diagnostics Incorporated
WOLF	Wolfspeed, Inc.
USEA	United Maritime Corporation
VSTO	Vista Outdoor Inc.
CMA	Comerica Incorporated
SSHPF	Vow ASA
AHG	Akso Health Group
CNM	Core & Main, Inc.
THMO	ThermoGenesis Holdings, Inc.
NSKFF	Kongsberg Gruppen ASA
OSCR	Oscar Health, Inc.
COUR	Coursera, Inc.
SALM	Salem Media Group, Inc.
SGHT	Sight Sciences, Inc.
IMXI	International Money Express, Inc.
NMTC	NeuroOne Medical Technologies Corporation
NCMI	National CineMedia, Inc.
SMFTF	Smurfit Kappa Group Plc
SZGPF	Salzgitter AG
APO	Apollo Global Management, Inc.
AHC	A. H. Belo Corporation
MOD	Modine Manufacturing Company
CTVA	Corteva, Inc.
CWK	Cushman & Wakefield plc
AMBR	Amber International Holding Ltd
CXT	Crane NXT, Co.
AMPE	Ampio Pharmaceuticals, Inc.
ASTL	Algoma Steel Group Inc.
XYF	X Financial
BARK	BARK, Inc.
MHLD	Maiden Holdings, Ltd.
TIVC	Tivic Health Systems, Inc.
CYD	China Yuchai International Limited
LFST	LifeStance Health Group, Inc.
GM	General Motors Company
DKL	Delek Logistics Partners, LP
OLB	The OLB Group, Inc.
EA	Electronic Arts Inc.
CION	CION Investment Corporation
AJX	Great Ajax Corp.
SDCH	SideChannel, Inc.
VVI	Viad Corp
FLO	Flowers Foods, Inc.
TLYS	Tilly's, Inc.
UBS	UBS Group AG
AVTBF	Avant Brands Inc.
SWDBF	Swedbank AB (publ)
NKE	NIKE, Inc.
GSL	Global Ship Lease, Inc.
DT	Dynatrace, Inc.
EMRAF	Emera Incorporated
TCOM	Trip.com Group Limited
OXSQ	Oxford Square Capital Corp.
GCO	Genesco Inc.
TAGOF	TAG Immobilien AG
SMDM	The Singing Machine Company, Inc.
TGT	Target Corporation
CLVR	Clever Leaves Holdings Inc.
RXST	RxSight, Inc.
GIC	Global Industrial Company
SRDX	Surmodics, Inc.
VNDA	Vanda Pharmaceuticals Inc.
ENV	Envestnet, Inc.
YHGJ	Yunhong Green CTI Ltd.
EGP	EastGroup Properties, Inc.
TNL	Travel + Leisure Co.
HE	Hawaiian Electric Industries, Inc.
ESALF	Eisai Co., Ltd.
MCFE	McAfee Corp.
CPLG	CorePoint Lodging Inc.
DINO	HF Sinclair Corporation
HRL	Hormel Foods Corporation
API	Agora, Inc.
CHKP	Check Point Software Technologies Ltd.
SEIC	SEI Investments Company
AMCX	AMC Networks Inc.
BABA	Alibaba Group Holding Limited
KNF	Knife River Corporation
IPG	The Interpublic Group of Companies, Inc.
ENLC	EnLink Midstream, LLC
LVRO	Lavoro Limited
RXMD	Progressive Care, Inc.
BFXXQ	BowFlex Inc.
KOF	Coca-Cola FEMSA, S.A.B. de C.V.
KRKR	36Kr Holdings Inc.
LOPE	Grand Canyon Education, Inc.
HEAR	Turtle Beach Corporation
AMRN	Amarin Corporation plc
JCI	Johnson Controls International plc
AMBFF	Ambu A/S
GBDC	Golub Capital BDC, Inc.
LYB	LyondellBasell Industries N.V.
CSAN	Cosan S.A.
SEDG	SolarEdge Technologies, Inc.
KAI	Kadant Inc.
KAR	OPENLANE, Inc.
YSG	Yatsen Holding Limited
SCCO	Southern Copper Corporation
LAW	CS Disco, Inc.
CVGW	Calavo Growers, Inc.
FORM	FormFactor, Inc.
FRFHF	Fairfax Financial Holdings Limited
AXL	American Axle & Manufacturing Holdings, Inc.
ONEW	OneWater Marine Inc.
XFOR	X4 Pharmaceuticals, Inc.
SOTK	Sono-Tek Corporation
LLY	Eli Lilly and Company
SFFLY	Schaeffler AG
FBASF	Fibra UNO
LRN	Stride, Inc.
GEVO	Gevo, Inc.
MCFT	MasterCraft Boat Holdings, Inc.
MCS	The Marcus Corporation
RQHTF	Reliq Health Technologies Inc.
LGVN	Longeveron Inc.
MCK	McKesson Corporation
HUBC	HUB Cyber Security Ltd.
PETQ	PetIQ, Inc.
AIG	American International Group, Inc.
AXGN	AxoGen, Inc.
MOS	The Mosaic Company
TTEK	Tetra Tech, Inc.
MPLX	MPLX Lp
IPDN	Professional Diversity Network, Inc.
LQDA	Liquidia Corporation
CRESY	Cresud Sociedad Anónima, Comercial, Inmobiliaria, Financiera y Agropecuaria
MRC	MRC Global Inc.
TXNM	TXNM Energy, Inc.
SEER	Seer, Inc.
GFL	GFL Environmental Inc.
WSR	Whitestone REIT
WRAP	Wrap Technologies, Inc.
FPH	Five Point Holdings, LLC
GIFI	Gulf Island Fabrication, Inc.
AYI	Acuity Brands, Inc.
ODMUF	Old Mutual Limited
TIG	Trean Insurance Group, Inc.
TPL	Texas Pacific Land Corporation
NRG	NRG Energy, Inc.
ELUXY	AB Electrolux (publ)
RDWR	Radware Ltd.
BTTR	Better Choice Company Inc.
KSHB	KushCo Holdings, Inc.
CR	Crane Company
BR	Broadridge Financial Solutions, Inc.
TPZ	Tortoise Power and Energy Infrastructure Fund, Inc.
THR	Thermon Group Holdings, Inc.
TFPM	Triple Flag Precious Metals Corp.
DTST	Data Storage Corporation
ESRT	Empire State Realty Trust, Inc.
XPON	Expion360 Inc.
WIT	Wipro Limited
EVR	Evercore Inc.
RGNX	REGENXBIO Inc.
PSTL	Postal Realty Trust, Inc.
ACEL	Accel Entertainment, Inc.
CSTM	Constellium SE
DCOM	Dime Community Bancshares, Inc.
SNV	Synovus Financial Corp.
SILA	Sila Realty Trust, Inc.
CRARF	Crédit Agricole S.A.
BWXT	BWX Technologies, Inc.
LLAP	Terran Orbital Corporation
STECF	Scatec ASA
ZGN	Ermenegildo Zegna N.V.
KBAGF	Koninklijke BAM Groep nv
ECO	Okeanis Eco Tankers Corp.
QFIN	Qifu Technology, Inc.
CDP	COPT Defense Properties
GPUS	Hyperscale Data, Inc.
BYU	BAIYU Holdings, Inc.
ASAN	Asana, Inc.
TSCO	Tractor Supply Company
BCH	Banco de Chile
FA	First Advantage Corporation
GUTS	Fractyl Health, Inc. Common Stock
MAC	The Macerich Company
NNXPF	NanoXplore Inc.
FNNTF	flatexDEGIRO AG
TYGO	Tigo Energy, Inc.
BCDA	BioCardia, Inc.
MAGN	Magnera Corp.
INTC	Intel Corporation
RMBL	RumbleON, Inc.
BEPC	Brookfield Renewable Corporation
SPRU	Spruce Power Holding Corporation
DDD	3D Systems Corporation
QSR	Restaurant Brands International Inc.
SKX	Skechers U.S.A., Inc.
ONB	Old National Bancorp
SFUNY	Fang Holdings Limited
CAE	CAE Inc.
LXP	LXP Industrial Trust
CARR	Carrier Global Corporation
CWBR	CohBar, Inc.
SWI	SolarWinds Corporation
CIB	Bancolombia S.A.
JOYY	JOYY Inc.
DRXGF	Drax Group plc
GKOS	Glaukos Corporation
MOTS	Motus GI Holdings, Inc.
RHP	Ryman Hospitality Properties, Inc.
BTDR	Bitdeer Technologies Group
STRM	Streamline Health Solutions, Inc.
TENB	Tenable Holdings, Inc.
INSW	International Seaways, Inc.
OCUL	Ocular Therapeutix, Inc.
BLWYF	Bellway p.l.c.
NEXCF	NexTech AR Solutions Corp.
GBT	Global Blood Therapeutics, Inc.
TYG	Tortoise Energy Infrastructure Corporation
NGVC	Natural Grocers by Vitamin Cottage, Inc.
OR	OR Royalties Inc.
GMINF	G Mining Ventures Corp.
ALHC	Alignment Healthcare, Inc.
STG	Sunlands Technology Group
FISI	Financial Institutions, Inc.
SWM	Schweitzer-Mauduit International, Inc.
SMI	VanEck HIP Sustainable Muni ETF
ASMIY	ASM International N.V.
PALAF	Paladin Energy Ltd
DOX	Amdocs Limited
HIMS	Hims & Hers Health, Inc.
MBWM	Mercantile Bank Corporation
NPKI	NPK International Inc.
BOH	Bank of Hawaii Corporation
HRTFF	Silver Lake Ontario Inc.
RITM	Rithm Capital Corp.
NYT	The New York Times Company
OPTN	OptiNose, Inc.
RKT	Rocket Companies, Inc.
SCHN	Schnitzer Steel Industries, Inc.
ZWS	Zurn Elkay Water Solutions Corporation
SHPW	Shapeways Holdings, Inc.
OKE	ONEOK, Inc.
SULZF	Sulzer Ltd
BIOX	Bioceres Crop Solutions Corp.
DVLT	Datavault AI Inc.
RBGLY	Reckitt Benckiser Group plc
LBAI	Lakeland Bancorp, Inc.
PBA	Pembina Pipeline Corporation
UGEIF	UGE International Ltd.
CICHY	China Construction Bank Corporation
BIRD	Allbirds, Inc.
MLCO	Melco Resorts & Entertainment Limited
CNGGF	Cann Group Limited
PRI	Primerica, Inc.
QGEN	Qiagen N.V.
NURO	NeuroMetrix, Inc.
BAX	Baxter International Inc.
TBBK	The Bancorp, Inc.
SJW	SJW Group
GME	GameStop Corp.
AAON	AAON, Inc.
RF	Regions Financial Corporation
RRX	Regal Rexnord Corporation
ONCT	Oncternal Therapeutics, Inc.
SBFFF	SBM Offshore N.V.
SXT	Sensient Technologies Corporation
KIO	KKR Income Opportunities Fund
MKC	McCormick & Company, Incorporated
SGH	SMART Global Holdings, Inc.
ZH	Zhihu Inc.
SON	Sonoco Products Company
BECN	Beacon Roofing Supply, Inc.
CTEV	Claritev Corporation
KHTRF	Knight Therapeutics Inc.
BRBR	BellRing Brands, Inc.
GBX	The Greenbrier Companies, Inc.
CPRI	Capri Holdings Limited
NVDA	NVIDIA Corporation
COHN	Cohen & Company Inc.
DZSI	DZS Inc.
VCSA	Vacasa, Inc.
ABG	Asbury Automotive Group, Inc.
THC	Tenet Healthcare Corporation
EVKIF	Evonik Industries AG
VAC	Marriott Vacations Worldwide Corporation
TMUS	T-Mobile US, Inc.
CNTG	Centogene N.V.
NOTE	FiscalNote Holdings, Inc.
DFS	Discover Financial Services
AAALF	Aareal Bank AG
RTLR	Rattler Midstream LP
CADE	Cadence Bank
MIMO	Airspan Networks Holdings Inc.
CFRHF	Compagnie Financière Richemont S.A.
BLUE	bluebird bio, Inc.
U	Unity Software Inc.
KLAC	KLA Corporation
FANG	Diamondback Energy, Inc.
SNES	SenesTech, Inc.
VSCO	Victoria's Secret & Co.
ALTR	Altair Engineering Inc.
VSH	Vishay Intertechnology, Inc.
VYX	NCR Voyix Corporation
PTC	PTC Inc.
OSW	OneSpaWorld Holdings Limited
HESM	Hess Midstream LP
BXC	BlueLinx Holdings Inc.
CFMOF	Cofinimmo S.A.
WTTR	Select Energy Services, Inc.
GAN	GAN Limited
BLZE	Backblaze, Inc.
INTR	Inter & Co, Inc.
BMI	Badger Meter, Inc.
CAPMF	Capgemini SE
DTCB	Solo Brands, Inc.
AEG	Aegon Ltd.
CGA	China Green Agriculture, Inc.
PEV	Phoenix Motor Inc.
SBSAA	Spanish Broadcasting System, Inc.
CIHKY	China Merchants Bank Co., Ltd.
LNZA	LanzaTech Global, Inc.
KIGRY	KION Group AG
CC	The Chemours Company
CHWY	Chewy, Inc.
CCSI	Consensus Cloud Solutions, Inc.
DYNT	Dynatronics Corporation
MINM	Minim, Inc.
HITI	High Tide Inc.
DAWN	Day One Biopharmaceuticals, Inc.
CSGS	CSG Systems International, Inc.
AUOTY	AUO Corporation
CRSR	Corsair Gaming, Inc.
CBWBF	Canadian Western Bank
CSSE	Chicken Soup for the Soul Entertainment, Inc.
STX	Seagate Technology Holdings plc
BBDO	Banco Bradesco S.A.
CTS	CTS Corporation
EOSE	Eos Energy Enterprises, Inc.
RDGT	Ridgetech Inc.
CWH	Camping World Holdings, Inc.
DCI	Donaldson Company, Inc.
OSTK	Overstock.com, Inc.
DCO	Ducommun Incorporated
ELME	Elme Communities
DIS	The Walt Disney Company
DOYU	DouYu International Holdings Limited
NETZ.NE	Carbon Streaming Corporation
DMTKQ	DermTech, Inc.
DV	DoubleVerify Holdings, Inc.
EEX	Emerald Holding, Inc.
EL	The Estée Lauder Companies Inc.
SVNLF	Svenska Handelsbanken AB (publ)
COWN	Cowen Inc.
ENOV	Enovis Corporation
FBP	First BanCorp.
HYZN	Hyzon Motors Inc.
SANG	Sangoma Technologies Corporation
NXPGF	Mobico Group Plc
FFIC	Flushing Financial Corporation
FIS	Fidelity National Information Services, Inc.
PLX	Protalix BioTherapeutics, Inc.
CATY	Cathay General Bancorp
PFLT	PennantPark Floating Rate Capital Ltd.
BRKL	Brookline Bancorp, Inc.
FNB	F.N.B. Corporation
GVA	Granite Construction Incorporated
CWBHF	Charlotte's Web Holdings, Inc.
NTES	NetEase, Inc.
GPRE	Green Plains Inc.
BDX	Becton, Dickinson and Company
RGR	Sturm, Ruger & Company, Inc.
SHWZ	Medicine Man Technologies, Inc.
FPAFY	First Pacific Company Limited
INVZ	Innoviz Technologies Ltd.
DRNA	Dicerna Pharmaceuticals, Inc.
SWAV	ShockWave Medical, Inc.
PFIE	Profire Energy, Inc.
GES	Guess', Inc.
VRAR	The Glimpse Group, Inc.
GLOB	Globant S.A.
MNTX	Manitex International, Inc.
GNTY	Guaranty Bancshares, Inc.
GROW	U.S. Global Investors, Inc.
GSBC	Great Southern Bancorp, Inc.
CAMP	CAMP4 Therapeutics Corporation
GTX	Garrett Motion Inc.
HD	The Home Depot, Inc.
BCUCF	Brunello Cucinelli S.p.A.
SIFY	Sify Technologies Limited
BNS	The Bank of Nova Scotia
GV	Visionary Holdings Inc.
BPOSF	bpost NV/SA
HLF	Herbalife Nutrition Ltd.
FSS	Federal Signal Corporation
ASHTF	Ashtead Group plc
BDR	Blonder Tongue Laboratories, Inc.
GIGM	GigaMedia Limited
CVV	CVD Equipment Corporation
ICHR	Ichor Holdings, Ltd.
INVX	Innovex Downhole Solutions Inc
ATEX	Anterix Inc.
IPI	Intrepid Potash, Inc.
CVAC	CureVac N.V.
SYRS	Syros Pharmaceuticals, Inc.
MLFNF	Maple Leaf Foods Inc.
LBRDK	Liberty Broadband Corporation
FLL	Full House Resorts, Inc.
IT	Gartner, Inc.
SHLLF	Shelf Drilling, Ltd.
ICON	Icon Energy Corp.
CNA	CNA Financial Corporation
H	Hyatt Hotels Corporation
KW	Kennedy-Wilson Holdings, Inc.
NVX	Novonix Limited
CXBMF	Calibre Mining Corp.
ALIZF	Allianz SE
IBTX	Independent Bank Group, Inc.
TOLWF	Trican Well Service Ltd.
ULH	Universal Logistics Holdings, Inc.
SNCR	Synchronoss Technologies, Inc.
OMIC	Singular Genomics Systems, Inc.
KFY	Korn Ferry
ABBV	AbbVie Inc.
AEO	American Eagle Outfitters, Inc.
PRCH	Porch Group, Inc.
PLAB	Photronics, Inc.
SPRO	Spero Therapeutics, Inc.
TLIS	Talis Biomedical Corporation
AKBA	Akebia Therapeutics, Inc.
SKYT	SkyWater Technology, Inc.
BCOV	Brightcove Inc.
AFG	American Financial Group, Inc.
GWW	W.W. Grainger, Inc.
IPA	ImmunoPrecise Antibodies Ltd.
BOUYF	Bouygues S.A.
FTV	Fortive Corporation
WNS	WNS (Holdings) Limited
CODI	Compass Diversified
LEGH	Legacy Housing Corporation
MSA	MSA Safety Incorporated
SAH	Sonic Automotive, Inc.
ET	Energy Transfer LP
AVY	Avery Dennison Corporation
RNST	Renasant Corporation
NSANY	Nissan Motor Co., Ltd.
EMR	Emerson Electric Co.
CBU	Community Bank System, Inc.
PRG	PROG Holdings, Inc.
DGGXF	DigitalX Limited
USFD	US Foods Holding Corp.
WRBY	Warby Parker Inc.
IMYSF	Imerys S.A.
NABL	N-able, Inc.
SZLSF	StageZero Life Sciences Ltd.
ALIT	Alight, Inc.
FAST	Fastenal Company
AOCIF	AutoCanada Inc.
WNDLF	Wendel
LRCX	Lam Research Corporation
BGCP	BGC Partners, Inc.
GTLS	Chart Industries, Inc.
AB	AllianceBernstein Holding L.P.
RGCO	RGC Resources, Inc.
BBGI	Beasley Broadcast Group, Inc.
MAPGF	Mapletree Logistics Trust
GMDA	Gamida Cell Ltd.
CRNT	Ceragon Networks Ltd.
CPA	Copa Holdings, S.A.
UXIN	Uxin Limited
CVCO	Cavco Industries, Inc.
SWSSF	Swiss Water Decaffeinated Coffee Inc.
COCO	The Vita Coco Company, Inc.
LYSCF	Lynas Rare Earths Limited
FFBC	First Financial Bancorp.
PINC	Premier, Inc.
AKAM	Akamai Technologies, Inc.
ACB	Aurora Cannabis Inc.
ASML	ASML Holding N.V.
BTU	Peabody Energy Corporation
MBLY	Mobileye Global Inc.
HTHIY	Hitachi, Ltd.
CYBN	Cybin Inc.
DHIL	Diamond Hill Investment Group, Inc.
DCGO	DocGo Inc.
QDEL	QuidelOrtho Corporation
TYEKF	thyssenkrupp AG
DOCRF	CloudMD Software & Services Inc.
EPSN	Epsilon Energy Ltd.
ZYME	Zymeworks Inc.
ODP	The ODP Corporation
PSFE	Paysafe Limited
VBVBF	VERBIO Vereinigte BioEnergie AG
BFRA	Biofrontera AG
ROOT	Root, Inc.
MX	Magnachip Semiconductor Corporation
SAGE	Sage Therapeutics, Inc.
EFXT	Enerflex Ltd.
NDRA	ENDRA Life Sciences Inc.
BE	Bloom Energy Corporation
BANR	Banner Corporation
CTLP	Cantaloupe, Inc.
AUVI	Applied UV, Inc.
HPP	Hudson Pacific Properties, Inc.
AMSSY	ams-OSRAM AG
DLTR	Dollar Tree, Inc.
POLA	Polar Power, Inc.
SMPL	The Simply Good Foods Company
UCTT	Ultra Clean Holdings, Inc.
CMS	CMS Energy Corporation
CRM	Salesforce, Inc.
AMD	Advanced Micro Devices, Inc.
LEJU	Leju Holdings Limited
WWE	World Wrestling Entertainment, Inc.
VNCE	Vince Holding Corp.
D	Dominion Energy, Inc.
AFYA	Afya Limited
APPS	Digital Turbine, Inc.
FANH	Fanhua Inc.
EXPGF	Experian plc
BELFB	Bel Fuse Inc.
CASH	Pathward Financial, Inc.
PYCR	Paycor HCM, Inc.
CECO	CECO Environmental Corp.
HMCBF	Home Capital Group Inc.
NHNCF	NAVER Corporation
HERXF	Héroux-Devtek Inc.
AMMX	AmeraMex International, Inc.
AGRO	Adecoagro S.A.
GRYP	Gryphon Digital Mining, Inc.
COST	Costco Wholesale Corporation
CRDO	Credo Technology Group Holding Ltd
KSPI	Joint Stock Company Kaspi.kz
ILIKF	Ilika plc
V	Visa Inc.
DUO	Fangdd Network Group Ltd.
PIRS	Pieris Pharmaceuticals, Inc.
VERI	Veritone, Inc.
FIVE	Five Below, Inc.
ENLAY	Enel S.p.A.
RDFN	Redfin Corporation
FRBA	First Bank
QIWI	QIWI plc
EXPE	Expedia Group, Inc.
IAFNF	iA Financial Corporation Inc.
ACRS	Aclaris Therapeutics, Inc.
SUM	Summit Materials, Inc.
QRHC	Quest Resource Holding Corporation
ARDX	Ardelyx, Inc.
FEIM	Frequency Electronics, Inc.
FLXS	Flexsteel Industries, Inc.
HGV	Hilton Grand Vacations Inc.
KARO	Karooooo Ltd.
BLDR	Builders FirstSource, Inc.
KPTSF	KP Tissue Inc.
KXSCF	Kinaxis Inc.
MHGVY	Mowi ASA
GCMG	Grosvenor Capital Management, L.P.
CEMI	Chembio Diagnostics, Inc.
GNTX	Gentex Corporation
MGI	MoneyGram International, Inc.
HBCP	Home Bancorp, Inc.
QURE	uniQure N.V.
PLNHF	Planet 13 Holdings Inc.
PRPO	Precipio, Inc.
APPN	Appian Corporation
PLNH	Planet 13 Holdings Inc.
ETRGF	Entourage Health Corp.
LADR	Ladder Capital Corp
JKHY	Jack Henry & Associates, Inc.
NOG	Northern Oil and Gas, Inc.
NEUE	NeueHealth, Inc.
LTRX	Lantronix, Inc.
MAIN	Main Street Capital Corporation
KDSKF	Koninklijke DSM N.V.
LITE	Lumentum Holdings Inc.
ROKU	Roku, Inc.
CTRN	Citi Trends, Inc.
TPRFF	Aris Mining Corporation
EDR	Endeavor Group Holdings, Inc.
CHYHY	Chr. Hansen Holding A/S
YLWDF	Yellow Pages Limited
LOVE	The Lovesac Company
LQDT	Liquidity Services, Inc.
WSTL	Westell Technologies, Inc.
CE	Celanese Corporation
TBCRF	Timbercreek Financial Corp.
LWAY	Lifeway Foods, Inc.
GRNWF	Greenlane Renewables Inc.
MBUU	Malibu Boats, Inc.
MEDP	Medpace Holdings, Inc.
MQ	Marqeta, Inc.
MDB	MongoDB, Inc.
SLGWF	SLANG Worldwide Inc.
MGIC	Magic Software Enterprises Ltd.
ABNB	Airbnb, Inc.
EFSC	Enterprise Financial Services Corp
DLPN	Dolphin Entertainment, Inc.
ICCC	ImmuCell Corporation
EVVTY	Evolution AB (publ)
PACK	Ranpak Holdings Corp.
AVD	American Vanguard Corporation
QNST	QuinStreet, Inc.
SFM	Sprouts Farmers Market, Inc.
NAPA	The Duckhorn Portfolio, Inc.
RAVE	RAVE Restaurant Group, Inc.
ZIM	ZIM Integrated Shipping Services Ltd.
VALE	Vale S.A.
RDSMY	Koninklijke DSM N.V.
STRL	Sterling Infrastructure, Inc.
SRTS	Sensus Healthcare, Inc.
THCH	TH International Limited
IVR	Invesco Mortgage Capital Inc.
TRIRF	Triterras, Inc.
ESVIF	Ensign Energy Services Inc.
SISXF	Savaria Corporation
HOPE	Hope Bancorp, Inc.
FITB	Fifth Third Bancorp
UPST	Upstart Holdings, Inc.
ADYEY	Adyen N.V.
AVIR	Atea Pharmaceuticals, Inc.
HCSG	Healthcare Services Group, Inc.
FLOW	Global X U.S. Cash Flow Kings 100 ETF
CWT	California Water Service Group
SGBAF	Ses S.a.
NPNYY	Nippon Yusen Kabushiki Kaisha
MRMD	MariMed Inc.
MPC	Marathon Petroleum Corporation
FHSEY	First High-School Education Group Co., Ltd.
VTRU	Vitru Limited
PRTS	CarParts.com, Inc.
LTCH	Latch, Inc.
SNFCA	Security National Financial Corporation
KSS	Kohl's Corporation
COOK	Traeger, Inc.
SLTTF	Slate Office REIT
IART	Integra LifeSciences Holdings Corporation
WKCMF	Wacker Chemie AG
VTNR	Vertex Energy, Inc.
AX	Axos Financial, Inc.
AMRK	A-Mark Precious Metals, Inc.
BWLP	BW LPG Limited
GLASF	Glass House Brands Inc.
HLKHF	HELLA GmbH & Co. KGaA
NDAQ	Nasdaq, Inc.
BEN	Franklin Resources, Inc.
VCISF	Vinci S.A.
BLFS	BioLife Solutions, Inc.
CRBP	Corbus Pharmaceuticals Holdings, Inc.
HOOK	HOOKIPA Pharma Inc.
CETX	Cemtrex, Inc.
CQP	Cheniere Energy Partners, L.P.
AVGR	Avinger, Inc.
WEIGF	The Weir Group PLC
HR	Healthcare Realty Trust Incorporated
ODC	Oil-Dri Corporation of America
ARWR	Arrowhead Pharmaceuticals, Inc.
PNC	The PNC Financial Services Group, Inc.
UNVR	Univar Solutions Inc.
CELH	Celsius Holdings, Inc.
AMN	AMN Healthcare Services, Inc.
WKSP	Worksport Ltd.
MUFG	Mitsubishi UFJ Financial Group, Inc.
ANF	Abercrombie & Fitch Co.
CRVL	CorVel Corporation
VBTX	Veritex Holdings, Inc.
MPSYF	MorphoSys AG
MRSN	Mersana Therapeutics, Inc.
ANZGY	ANZ Group Holdings Limited
URGN	UroGen Pharma Ltd.
ALNY	Alnylam Pharmaceuticals, Inc.
MGRUF	Morguard Real Estate Investment Trust
WRDEF	Wereldhave N.V.
AAL	American Airlines Group Inc.
EMKR	EMCORE Corporation
USIO	Usio, Inc.
FRRPF	Fiera Capital Corporation
ERF	Enerplus Corporation
DORM	Dorman Products, Inc.
SDRL	Seadrill Limited
VRSN	VeriSign, Inc.
CLX	The Clorox Company
JILL	J.Jill, Inc.
PENG	Penguin Solutions, Inc.
BBLNF	Babylon Holdings Limited
HOFV	Hall of Fame Resort & Entertainment Company
AMWL	American Well Corporation
RVMD	Revolution Medicines, Inc.
RYHTY	Ryman Healthcare Limited
TSVT	2seventy bio, Inc.
ACRX	AcelRx Pharmaceuticals, Inc.
SYK	Stryker Corporation
XENE	Xenon Pharmaceuticals Inc.
DIISF	Direct Line Insurance Group plc
CMCT	Creative Media & Community Trust Corporation
BOKF	BOK Financial Corporation
BEKE	KE Holdings Inc.
CASY	Casey's General Stores, Inc.
PNNT	PennantPark Investment Corporation
ASYS	Amtech Systems, Inc.
CNF	CNFinance Holdings Limited
HXGCF	Hexagon Composites ASA
CHTR	Charter Communications, Inc.
CNOB	ConnectOne Bancorp, Inc.
VRRM	Verra Mobility Corporation
CRUS	Cirrus Logic, Inc.
DIOD	Diodes Incorporated
EVO	Evotec SE
ADXS	Advaxis, Inc.
EXAS	Exact Sciences Corporation
EXTR	Extreme Networks, Inc.
STAB	Statera Biopharma, Inc.
SUMXF	Supremex Inc.
APD	Air Products and Chemicals, Inc.
BPYPO	Brookfield Property Partners L.P.
TELDF	Telefónica Deutschland Holding AG
CAAS	China Automotive Systems, Inc.
EXPI	eXp World Holdings, Inc.
FSV	FirstService Corporation
SEEMF	Seeing Machines Limited
GLPI	Gaming and Leisure Properties, Inc.
MRT	Marti Technologies, Inc.
GOSS	Gossamer Bio, Inc.
JRVR	James River Group Holdings, Ltd.
GPRO	GoPro, Inc.
FIEE	FiEE, Inc.
IRTC	iRhythm Technologies, Inc.
HBIO	Harvard Bioscience, Inc.
SWTX	SpringWorks Therapeutics, Inc.
HQY	HealthEquity, Inc.
K	Kellanova
THQQF	Embracer Group AB (publ)
AHCO	AdaptHealth Corp.
BLND	Blend Labs, Inc.
IAS	Integral Ad Science Holding Corp.
ESGR	Enstar Group Limited
CRI	Carter's, Inc.
IPAR	Inter Parfums, Inc.
SZCRF	SCOR Se
ANIOY	Acerinox, S.A.
KALU	Kaiser Aluminum Corporation
KELYA	Kelly Services, Inc.
PIK	Kidpik Corp.
LTRN	Lantern Pharma Inc.
MNDY	monday.com Ltd.
EDPFY	EDP - Energias de Portugal, S.A.
ACHC	Acadia Healthcare Company, Inc.
EWCZ	European Wax Center, Inc.
BWAY	BrainsWay Ltd.
ELV	Elevance Health Inc.
MLYS	Mineralys Therapeutics, Inc.
CPTN	Cepton, Inc.
ISPO	Inspirato Incorporated
PSTV	Plus Therapeutics, Inc.
ARB	AltShares Merger Arbitrage ETF
MKSI	MKS Inc.
MKTX	MarketAxess Holdings Inc.
SVNDY	Seven & i Holdings Co., Ltd.
PACW	PacWest Bancorp
STRYQ	Starry Group Holdings, Inc.
EW	Edwards Lifesciences Corporation
SAFE	Safehold Inc.
IDRSF	Idorsia Ltd
AXSM	Axsome Therapeutics, Inc.
CTAS	Cintas Corporation
AEYGQ	ADDvantage Technologies Group, Inc.
MITSF	Mitsui & Co., Ltd.
SUMCF	Sumco Corporation
ALGM	Allegro MicroSystems, Inc.
RES	RPC, Inc.
ALBKY	Alpha Services and Holdings S.A.
RKUNY	Rakuten Group, Inc.
PXLW	Pixelworks, Inc.
IKTSF	Intertek Group plc
RDUS	Radius Recycling, Inc.
HHS	Harte Hanks, Inc.
BDRL	Blonder Tongue Laboratories, Inc.
AIU	Meta Data Limited
SYF	Synchrony Financial
SPMYY	Spirent Communications plc
MGY	Magnolia Oil & Gas Corporation
SHCR	Sharecare, Inc.
USM	United States Cellular Corporation
VGR	Vector Group Ltd.
AGM	Federal Agricultural Mortgage Corporation
NXRT	NexPoint Residential Trust, Inc.
INDB	Independent Bank Corp.
SPMC	Sound Point Meridian Capital Inc
KBNT	Kubient, Inc.
BLBD	Blue Bird Corporation
BMRC	Bank of Marin Bancorp
BSY	Bentley Systems, Incorporated
ILMN	Illumina, Inc.
CCOI	Cogent Communications Holdings, Inc.
CODX	Co-Diagnostics, Inc.
BCRX	BioCryst Pharmaceuticals, Inc.
YQ	17 Education & Technology Group Inc.
REED	Reed's, Inc.
MCD	McDonald's Corporation
CDNS	Cadence Design Systems, Inc.
OBDC	Blue Owl Capital Corporation
TS	Tenaris S.A.
GMVHF	Entain Plc
AGAE	Allied Gaming & Entertainment Inc.
LSPD	Lightspeed Commerce Inc.
NRC	National Research Corporation
SSUNF	SIGNA Sports United N.V.
STKS	The ONE Group Hospitality, Inc.
OPNT	Opiant Pharmaceuticals, Inc.
CNGO	Cengage Learning Holdings II, Inc.
PPC	Pilgrim's Pride Corporation
MDGEF	Medigene AG
TIGO	Millicom International Cellular S.A.
ADXN	Addex Therapeutics Ltd
POAI	Predictive Oncology Inc.
TRMB	Trimble Inc.
FPAY	FlexShopper, Inc.
PSTG	Pure Storage, Inc.
CMTL	Comtech Telecommunications Corp.
CEIX	CONSOL Energy Inc.
SIRI	Sirius XM Holdings Inc.
TVTX	Travere Therapeutics, Inc.
PERF	Perfect Corp.
MAN	ManpowerGroup Inc.
WY	Weyerhaeuser Company
GASS	StealthGas Inc.
DTRUY	Daimler Truck Holding AG
VODAF	Vodacom Group Limited
ALE	ALLETE, Inc.
LVLU	Lulu's Fashion Lounge Holdings, Inc.
PRSO	Peraso Inc.
FBK	FB Financial Corporation
BRKR	Bruker Corporation
BWEN	Broadwind, Inc.
SDCCQ	SmileDirectClub, Inc.
ZK	ZEEKR Intelligent Technology Holding Limited
SNWV	SANUWAVE Health, Inc.
CDTX	Cidara Therapeutics, Inc.
OXM	Oxford Industries, Inc.
DCFC	Tritium DCFC Limited
EDRY	EuroDry Ltd.
GDEV	GDEV Inc.
NTST	NETSTREIT Corp.
NIO	NIO Inc.
IR	Ingersoll Rand Inc.
ACM	Aecom
DYAI	Dyadic International, Inc.
OBK	Origin Bancorp, Inc.
SOHO	Sotherly Hotels Inc.
CPRT	Copart, Inc.
ACDC	ProFrac Holding Corp.
HIT	Health In Tech, Inc.
GLIBA	GCI Liberty, Inc.
TBIIF	Tobii AB (publ)
FELE	Franklin Electric Co., Inc.
PT	Pintec Technology Holdings Limited
CURB	Curbline Properties Corp.
FRPH	FRP Holdings, Inc.
SINT	Sintx Technologies, Inc.
HCANF	Halo Collective Inc.
GPLDF	Great Panther Mining Limited
GRPN	Groupon, Inc.
EUTLF	Eutelsat Communications S.A.
PRPH	ProPhase Labs, Inc.
GYRE	Gyre Therapeutics, Inc.
GFASY	Gafisa S.A.
FSTX	F-star Therapeutics, Inc.
CMPS	COMPASS Pathways plc
BBVA	Banco Bilbao Vizcaya Argentaria, S.A.
DBGI	Digital Brands Group, Inc.
AXTI	AXT, Inc.
LIN	Linde plc
TIIAY	Telecom Italia S.p.A.
ALTS	ALT5 Sigma Corporation
IPHA	Innate Pharma S.A.
LYRA	Lyra Therapeutics, Inc.
NCSM	NCS Multistage Holdings, Inc.
PNW	Pinnacle West Capital Corporation
KOS	Kosmos Energy Ltd.
MPLN	MultiPlan Corporation
JVA	Coffee Holding Co., Inc.
LILA	Liberty Latin America Ltd.
GNCGF	Greencore Group plc
AMVMF	AMG Advanced Metallurgical Group N.V.
MESO	Mesoblast Limited
CAPC	Capstone Companies, Inc.
ACIW	ACI Worldwide, Inc.
YTEN	Yield10 Bioscience, Inc.
WZZAF	Wizz Air Holdings Plc
HIVE	HIVE Blockchain Technologies Ltd.
ATR	AptarGroup, Inc.
ITOCF	ITOCHU Corporation
KN	Knowles Corporation
SRPT	Sarepta Therapeutics, Inc.
CXDO	Crexendo, Inc.
SRAX	SRAX, Inc.
TRIN	Trinity Capital Inc.
RNECF	Renesas Electronics Corporation
PROV	Provident Financial Holdings, Inc.
WBS	Webster Financial Corporation
PLYA	Playa Hotels & Resorts N.V.
ASPU	Aspen Group, Inc.
600036.SS	China Merchants Bank Co., Ltd.
CSGP	CoStar Group, Inc.
WRLD	World Acceptance Corporation
BKNG	Booking Holdings Inc.
CWYUF	SmartCentres Real Estate Investment Trust
ACXP	Acurx Pharmaceuticals, Inc.
GEG	Great Elm Group, Inc.
GLNG	Golar LNG Limited
OLK	Olink Holding AB (publ)
BGFV	Big 5 Sporting Goods Corporation
FINW	FinWise Bancorp
IAC	IAC InterActive Corp.
BLTE	Belite Bio, Inc
DOOO	BRP Inc.
EQ	Equillium, Inc.
CWCO	Consolidated Water Co. Ltd.
CYRNQ	Cyren Ltd.
ROAD	Construction Partners, Inc.
EVGN	Evogene Ltd.
TUIFF	Tui AG
ADC	Agree Realty Corporation
ALKS	Alkermes plc
TGSGY	Tgs Asa
XERS	Xeris Biopharma Holdings, Inc.
BBCP	Concrete Pumping Holdings, Inc.
FTNT	Fortinet, Inc.
RAND	Rand Capital Corporation
ADBE	Adobe Inc.
IPSEY	Ipsen S.A.
RMTI	Rockwell Medical, Inc.
XELB	Xcel Brands, Inc.
ALLT	Allot Ltd.
DGICA	Donegal Group Inc.
HRTG	Heritage Insurance Holdings, Inc.
OCX	OncoCyte Corporation
ALFNF	Alfen N.V.
AVT	Avnet, Inc.
AMGDF	Aston Martin Lagonda Global Holdings plc
ATOS	Atossa Therapeutics, Inc.
CIDM	Cinedigm Corp.
NJR	New Jersey Resources Corporation
JAMF	Jamf Holding Corp.
CRNCY	Capricorn Energy PLC
NTNX	Nutanix, Inc.
ABUS	Arbutus Biopharma Corporation
CURLF	Curaleaf Holdings, Inc.
CPS	Cooper-Standard Holdings Inc.
TTAN	ServiceTitan, Inc.
ADI	Analog Devices, Inc.
NEE	NextEra Energy, Inc.
MIR	Mirion Technologies, Inc.
CUK	Carnival Corporation & plc
GMPXF	RF Capital Group Inc.
DSRLF	DiaSorin S.p.A.
DARE	Daré Bioscience, Inc.
FATE	Fate Therapeutics, Inc.
FEDU	Four Seasons Education (Cayman) Inc.
NVO	Novo Nordisk A/S
INGXF	Innergex Renewable Energy Inc.
MTRX	Matrix Service Company
NCNO	nCino, Inc.
IEP	Icahn Enterprises L.P.
CTARF	Centaurus Energy Inc.
VBLT	Vascular Biogenics Ltd.
WGO	Winnebago Industries, Inc.
RNR	RenaissanceRe Holdings Ltd.
GGR	Gogoro Inc.
BWAGF	BAWAG Group AG
CLMT	Calumet, Inc.
FOLD	Amicus Therapeutics, Inc.
OUST	Ouster, Inc.
MET	MetLife, Inc.
CORT	Corcept Therapeutics Incorporated
BWA	BorgWarner Inc.
TEAM	Atlassian Corporation
ITCI	Intra-Cellular Therapies, Inc.
MFLTY	Missfresh Limited
DSKYF	Daiichi Sankyo Company, Limited
SAUHF	Straumann Holding AG
SNDR	Schneider National, Inc.
FLUX	Flux Power Holdings, Inc.
ONC	BeOne Medicines Ltd.
TITN	Titan Machinery Inc.
BL	BlackLine, Inc.
VRSK	Verisk Analytics, Inc.
NTCT	NetScout Systems, Inc.
OCINF	Oci N.V.
FGI	FGI Industries Ltd.
OGI	Organigram Global Inc.
KMB	Kimberly-Clark Corporation
TIO	Tingo Group, Inc.
IAG	IAMGOLD Corporation
TMDI	Titan Medical Inc.
ALRS	Alerus Financial Corporation
CHE	Chemed Corporation
BTSG	BrightSpring Health Services, Inc. Common Stock
OII	Oceaneering International, Inc.
CGTX	Cognition Therapeutics, Inc.
DMAC	DiaMedica Therapeutics Inc.
TU	TELUS Corporation
NSA	National Storage Affiliates Trust
CLFD	Clearfield, Inc.
BBDC	Barings BDC, Inc.
EHC	Encompass Health Corporation
ENLT	Enlight Renewable Energy Ltd
FCNCA	First Citizens BancShares, Inc.
CIO	City Office REIT, Inc.
BW	Babcock & Wilcox Enterprises, Inc.
SHEL	Shell plc
CKHUY	CK Hutchison Holdings Limited
EQT	EQT Corporation
CDXS	Codexis, Inc.
LEG	Leggett & Platt, Incorporated
LECO	Lincoln Electric Holdings, Inc.
DLTH	Duluth Holdings Inc.
DSGX	The Descartes Systems Group Inc.
DNTUF	Dentsu Group Inc.
ERII	Energy Recovery, Inc.
DH	Definitive Healthcare Corp.
RMGGF	Resolute Mining Limited
B	Barrick Mining Corporation
NNDM	Nano Dimension Ltd.
IVCGF	Iveco Group N.V.
AHH	Armada Hoffler Properties, Inc.
BFAM	Bright Horizons Family Solutions Inc.
UVSP	Univest Financial Corporation
KEP	Korea Electric Power Corporation
OEZVF	Verbund AG
HA	Hawaiian Holdings, Inc.
STOR	STORE Capital Corporation
FCBC	First Community Bankshares, Inc.
FLYW	Flywire Corporation
TELA	TELA Bio, Inc.
LUNG	Pulmonx Corporation
VLTA	Volta Inc.
GNFT	Genfit S.A.
EXETF	Extendicare Inc.
DNUT	Krispy Kreme, Inc.
UCL	uCloudlink Group Inc.
THGHY	THG Plc
FROG	JFrog Ltd.
GDEN	Golden Entertainment, Inc.
GTEC	Greenland Technologies Holding Corporation
MELI	MercadoLibre, Inc.
E	Eni S.p.A.
FTK	Flotek Industries, Inc.
BGAOF	Proximus PLC
JAZZ	Jazz Pharmaceuticals plc
JMPLF	Johnson Matthey Plc
ENZB	Enzo Biochem, Inc.
MRNS	Marinus Pharmaceuticals, Inc.
HBAN	Huntington Bancshares Incorporated
ASAPF	Aurora Spine Corporation
LINE	Lineage, Inc.
TATYF	Tate & Lyle plc
TKLF	Yoshitsu Co., Ltd
CRBG	Corebridge Financial, Inc.
CREX	Creative Realities, Inc.
TK	Teekay Corporation
HWM	Howmet Aerospace Inc.
EVOP	EVO Payments, Inc.
ICUI	ICU Medical, Inc.
PVAC	Penn Virginia Corporation
JTKWY	Just Eat Takeaway.com N.V.
BIOC	Biocept, Inc.
AIBRF	AIB Group plc
SC	Santander Consumer USA Holdings Inc.
CGGYY	Viridien
TRMLF	Tourmaline Oil Corp.
ASX	ASE Technology Holding Co., Ltd.
NGG	National Grid plc
ISO	IsoPlexis Corporation
III	Information Services Group, Inc.
GAXY	Galaxy Next Generation, Inc.
TWKS	Thoughtworks Holding, Inc.
UMPQ	Umpqua Holdings Corporation
INST	Instructure Holdings, Inc.
RYAAY	Ryanair Holdings plc
VCRA	Vocera Communications, Inc.
ISBC	Investors Bancorp, Inc.
ATTO	Atento S.A.
FLY	Fly Leasing Limited
BAM	Brookfield Asset Management Ltd.
CLI	Mack-Cali Realty Corporation
CATM	Cardtronics plc
SGMS	Scientific Games Corporation
INTA	Intapp, Inc.
NDCVF	Nordic Semiconductor ASA
VYLD	Inverse VIX Short-Term Futures ETNs due March 22 2045
IOVA	Iovance Biotherapeutics, Inc.
YHEKF	Yeahka Limited
GNUS	Genius Brands International, Inc.
LOGI	Logitech International S.A.
YELP	Yelp Inc.
MT	ArcelorMittal S.A.
DPDW	Koil Energy Solutions, Inc.
BWLLF	BW LPG Limited
TVTY	Tivity Health, Inc.
NEXN	Nexxen International Ltd.
FFIV	F5, Inc.
ALR	AlerisLife Inc.
RETA	Reata Pharmaceuticals, Inc.
MHK	Mohawk Industries, Inc.
LMAT	LeMaitre Vascular, Inc.
UTZ	Utz Brands, Inc.
MCHP	Microchip Technology Incorporated
AAWW	Atlas Air Worldwide Holdings, Inc.
MSLP	MusclePharm Corporation
FVE	Five Star Senior Living Inc.
ELP	Companhia Paranaense de Energia - COPEL
MMMB	MamaMancini's Holdings, Inc.
CRNX	Crinetics Pharmaceuticals, Inc.
BTAI	BioXcel Therapeutics, Inc.
ADUS	Addus HomeCare Corporation
AMED	Amedisys, Inc.
MOFG	MidWestOne Financial Group, Inc.
ALTG	Alta Equipment Group Inc.
CPCAY	Cathay Pacific Airways Limited
ORGS	Orgenesis Inc.
CODA	Coda Octopus Group, Inc.
SHOO	Steven Madden, Ltd.
FHB	First Hawaiian, Inc.
MOGU	MOGU Inc.
AGYS	Agilysys, Inc.
CI	The Cigna Group
ABSI	Absci Corporation
IESVF	Invinity Energy Systems plc
CATC	Cambridge Bancorp
MXCHF	Orbia Advance Corporation, S.A.B. de C.V.
ERMAF	Eramet S.a.
BOXL	Boxlight Corporation
BKR	Baker Hughes Company
MDIBF	Mediobanca Banca di Credito Finanziario S.p.A.
OILSF	Saturn Oil & Gas Inc.
MNRO	Monro, Inc.
ICFI	ICF International, Inc.
FWRD	Forward Air Corporation
COMM	CommScope Holding Company, Inc.
AIRI	Air Industries Group
BNDSF	Banco de Sabadell, S.A.
UHS	Universal Health Services, Inc.
RMAX	RE/MAX Holdings, Inc.
HZNOF	Dexterra Group Inc.
CPG	Crescent Point Energy Corp.
ON	ON Semiconductor Corporation
NVFY	Nova LifeStyle, Inc.
PLUS	ePlus inc.
MEIP	MEI Pharma, Inc.
HLIT	Harmonic Inc.
SBFG	SB Financial Group, Inc.
BXRXQ	Baudax Bio, Inc.
NCPL	Netcapital Inc.
AJG	Arthur J. Gallagher & Co.
DNBBY	DNB Bank ASA
WDFC	WD-40 Company
SEVN	Seven Hills Realty Trust
XTNT	Xtant Medical Holdings, Inc.
IIVI	II-VI Incorporated
NIXX	Nixxy, Inc.
ALMFF	Altium Limited
SMMT	Summit Therapeutics Inc.
DGLY	Digital Ally, Inc.
OLLI	Ollie's Bargain Outlet Holdings, Inc.
SESN	Sesen Bio, Inc.
NTAP	NetApp, Inc.
BEDU	Bright Scholar Education Holdings Limited
BMTX	BM Technologies, Inc.
CGC	Canopy Growth Corporation
EPAM	EPAM Systems, Inc.
TLSI	TriSalus Life Sciences, Inc.
MTNB	Matinas BioPharma Holdings, Inc.
FJTSF	Fujitsu Limited
ZD	Ziff Davis, Inc.
MAPS	WM Technology, Inc.
RYTM	Rhythm Pharmaceuticals, Inc.
BFRI	Biofrontera Inc.
MFCSF	Medical Facilities Corporation
BWIN	The Baldwin Insurance Group, Inc.
ISEE	IVERIC bio, Inc.
CB	Chubb Limited
EXEL	Exelixis, Inc.
PAGS	PagSeguro Digital Ltd.
BUD	Anheuser-Busch InBev SA/NV
ADTN	ADTRAN Holdings, Inc.
ABCAF	Athabasca Minerals Inc.
ALGN	Align Technology, Inc.
VINP	Vinci Partners Investments Ltd.
IAALF	IBC Advanced Alloys Corp.
WFCF	Where Food Comes From, Inc.
PSO	Pearson plc
OMCL	Omnicell, Inc.
SBAC	SBA Communications Corporation
EYE	National Vision Holdings, Inc.
PBSFF	ProSiebenSat.1 Media SE
GEL	Genesis Energy, L.P.
BON	Bon Natural Life Limited
PRMW	Primo Water Corporation
XOS	Xos, Inc.
STN	Stantec Inc.
PEGA	Pegasystems Inc.
FNV	Franco-Nevada Corporation
ROG	Rogers Corporation
PRAX	Praxis Precision Medicines, Inc.
BANX	ArrowMark Financial Corp.
SLE	Super League Enterprise, Inc.
GNRC	Generac Holdings Inc.
HTGM	HTG Molecular Diagnostics, Inc.
CAJ	Canon Inc.
SGRY	Surgery Partners, Inc.
MOLN	Molecular Partners AG
AVA	Avista Corporation
OPGN	OpGen, Inc.
NEON	Neonode Inc.
PR	Permian Resources Corporation
NERV	Minerva Neurosciences, Inc.
NTIC	Northern Technologies International Corporation
DOCMF	Dr. Martens plc
MRO	Marathon Oil Corporation
BV	BrightView Holdings, Inc.
NVEC	NVE Corporation
EXXAF	Exxaro Resources Limited
CHMI	Cherry Hill Mortgage Investment Corporation
SAM	The Boston Beer Company, Inc.
KEM	KraneShares Dynamic Emerging Markets Strategy ETF
DERM	Journey Medical Corporation
FOR	Forestar Group Inc.
ADEA	Adeia Inc.
ORCL	Oracle Corporation
UUUU	Energy Fuels Inc.
NVEE	NV5 Global, Inc.
CEO	CNOOC Limited
TWST	Twist Bioscience Corporation
HLNE	Hamilton Lane Incorporated
HGH	The Hartford Financial Services Group, Inc. DEB FIX/FLT 42
BASFY	BASF Se
YAYO	EVmo, Inc.
TRN	Trinity Industries, Inc.
OLED	Universal Display Corporation
AMH	American Homes 4 Rent
ARTW	Art's-Way Manufacturing Co., Inc.
WMMVY	Wal-Mart de México, S.A.B. de C.V.
RXT	Rackspace Technology, Inc.
OPRX	OptimizeRx Corporation
PASG	Passage Bio, Inc.
VNPKF	Verde AgriTech Ltd
ACAZF	Acadian Timber Corp.
TFX	Teleflex Incorporated
PAYO	Payoneer Global Inc.
PRO	PROS Holdings, Inc.
FHI	Federated Hermes, Inc.
WHLR	Wheeler Real Estate Investment Trust, Inc.
LNC	Lincoln National Corporation
SPRY	ARS Pharmaceuticals, Inc.
PCTY	Paylocity Holding Corporation
EE	Excelerate Energy, Inc.
SAN	Banco Santander, S.A.
OMVJF	Omv AG
JAKK	JAKKS Pacific, Inc.
TSPH	TuSimple Holdings Inc.
MYE	Myers Industries, Inc.
OTTR	Otter Tail Corporation
HYPOF	Hypoport SE
PARXF	Parex Resources Inc.
CEAD	CEA Industries Inc.
APEI	American Public Education, Inc.
ACCO	ACCO Brands Corporation
ZLDSF	Zalando SE
DUERF	Dürr AG
NOTV	Inotiv, Inc.
JHG	Janus Henderson Group plc
SSIC	Silver Spike Investment Corp.
ARI	Apollo Commercial Real Estate Finance, Inc.
SG	Sweetgreen, Inc.
QLYS	Qualys, Inc.
RSLS	ReShape Lifesciences Inc.
DTCBD	Solo Brands, Inc.
MED	Medifast, Inc.
GATX	GATX Corporation
FINMF	Leonardo S.p.A.
BMY	Bristol-Myers Squibb Company
AWRE	Aware, Inc.
SVA	Sinovac Biotech Ltd.
PCOR	Procore Technologies, Inc.
AMKR	Amkor Technology, Inc.
VNOM	Viper Energy, Inc.
RMBS	Rambus Inc.
REG	Regency Centers Corporation
ORC	Orchid Island Capital, Inc.
HNSBF	Hansa Biopharma AB (publ)
DFIN	Donnelley Financial Solutions, Inc.
FCEL	FuelCell Energy, Inc.
WIX	Wix.com Ltd.
SILK	Silk Road Medical, Inc
TECH	Bio-Techne Corporation
TTGT	TechTarget, Inc.
WB	Weibo Corporation
CVVTF	Covestro AG
KSIOF	Kneat.com, Inc.
SONY	Sony Group Corporation
SPGYF	Whitecap Resources Inc.
TMNSF	Temenos AG
IMAX	IMAX Corporation
CAPL	CrossAmerica Partners LP
CVE	Cenovus Energy Inc.
NREF	NexPoint Real Estate Finance, Inc.
KEX	Kirby Corporation
VLDR	Velodyne Lidar, Inc.
FIHL	Fidelis Insurance Holdings Limited
NDLS	Noodles & Company
SLS	SELLAS Life Sciences Group, Inc.
MERC	Mercer International Inc.
KBR	KBR, Inc.
GILT	Gilat Satellite Networks Ltd.
LULU	Lululemon Athletica Inc.
TWI	Titan International, Inc.
RRC	Range Resources Corporation
NKTR	Nektar Therapeutics
AZUL	Azul S.A.
SHNWF	Schroders plc
AFL	Aflac Incorporated
EQNR	Equinor ASA
PDEX	Pro-Dex, Inc.
SUBCY	Subsea 7 S.A.
CHEF	The Chefs' Warehouse, Inc.
REVG	REV Group, Inc.
PPL	PPL Corporation
IVZ	Invesco Ltd.
TRAW	Traws Pharma, Inc.
WBD	Warner Bros. Discovery, Inc.
JSDA	Jones Soda Co.
TTWO	Take-Two Interactive Software, Inc.
URBN	Urban Outfitters, Inc.
ARW	Arrow Electronics, Inc.
CWST	Casella Waste Systems, Inc.
MD	Pediatrix Medical Group, Inc.
XFLT	XAI Octagon Floating Rate & Alternative Income Term Trust
MGM	MGM Resorts International
ADPT	Adaptive Biotechnologies Corporation
SIDU	Sidus Space, Inc.
ANET	Arista Networks, Inc.
VRNA	Verona Pharma plc
EGO	Eldorado Gold Corporation
VLO	Valero Energy Corporation
SNDL	SNDL Inc.
RACE	Ferrari N.V.
BIGC	BigCommerce Holdings, Inc.
DPMLF	Dundee Precious Metals Inc.
ELMD	Electromed, Inc.
MGPI	MGP Ingredients, Inc.
SPGI	S&P Global Inc.
VOLT	Volt Information Sciences, Inc.
PRGO	Perrigo Company plc
FRPT	Freshpet, Inc.
NTPIF	Nam Tai Property Inc.
WEYS	Weyco Group, Inc.
PFGC	Performance Food Group Company
EVLO	Evelo Biosciences, Inc.
ATRO	Astronics Corporation
KR	The Kroger Co.
SM	SM Energy Company
ASTVF	Austevoll Seafood ASA
STC	Stewart Information Services Corporation
HLN	Haleon plc
KNOP	KNOT Offshore Partners LP
SDA	SunCar Technology Group Inc.
OVV	Ovintiv Inc.
YMAB	Y-mAbs Therapeutics, Inc.
CLGN	CollPlant Biotechnologies Ltd.
LASR	nLIGHT, Inc.
NKRKF	Nokian Renkaat Oyj
HTWSF	Helios Towers plc
OIS	Oil States International, Inc.
SQM	Sociedad Química y Minera de Chile S.A.
STNE	StoneCo Ltd.
CJJD	China Jo-Jo Drugstores, Inc.
PRVB	Provention Bio, Inc.
CNI	Canadian National Railway Company
EFOI	Energy Focus, Inc.
HIW	Highwoods Properties, Inc.
MXL	MaxLinear, Inc.
KINS	Kingstone Companies, Inc.
SQNS	Sequans Communications S.A.
UTL	Unitil Corporation
COOP	Mr. Cooper Group Inc.
APG	APi Group Corporation
HWC	Hancock Whitney Corporation
CVU	CPI Aerostructures, Inc.
VRE	Veris Residential, Inc.
MRVL	Marvell Technology, Inc.
PH	Parker-Hannifin Corporation
SCHW	The Charles Schwab Corporation
JCTC	Jewett-Cameron Trading Company Ltd.
BOMBF	Bombardier Inc.
CSII	Cardiovascular Systems, Inc.
HLMN	Hillman Solutions Corp.
NIU	Niu Technologies
AFIIQ	Armstrong Flooring, Inc.
HSII	Heidrick & Struggles International, Inc.
VOYA	Voya Financial, Inc.
LIVN	LivaNova PLC
LILAK	Liberty Latin America Ltd.
AES	The AES Corporation
AGNC	AGNC Investment Corp.
DMCOF	d'Amico International Shipping S.A.
DXC	DXC Technology Company
ARNC	Arconic Corporation
GEHC	GE HealthCare Technologies Inc.
AGFS	AgroFresh Solutions, Inc.
NTRS	Northern Trust Corporation
CYAN	Cyanotech Corporation
IOT	Samsara Inc.
ZUMZ	Zumiez Inc.
ITGR	Integer Holdings Corporation
ALL	The Allstate Corporation
FPI	Farmland Partners Inc.
IMV	IMV Inc.
MDT	Medtronic plc
GRAL	GRAIL, Inc.
Z	Zillow Group, Inc. Class C
DESP	Despegar.com, Corp.
CABO	Cable One, Inc.
DPBSF	Dampskibsselskabet Norden A/S
BVRDF	Bureau Veritas S.A.
MASS	908 Devices Inc.
CVBF	CVB Financial Corp.
SNT	Senstar Technologies Ltd.
SYM	Symbotic Inc.
SSNLF	Samsung Electronics Co., Ltd.
LGIQ	Logiq, Inc.
SWBI	Smith & Wesson Brands, Inc.
OSBC	Old Second Bancorp, Inc.
PHM	PulteGroup, Inc.
CRAI	CRA International, Inc.
OTEX	Open Text Corporation
ONON	On Holding AG
LW	Lamb Weston Holdings, Inc.
AYASF	Aya Gold & Silver Inc.
AMX	América Móvil, S.A.B. de C.V.
GAME	GameSquare Holdings, Inc.
USNZY	Usinas Siderúrgicas de Minas Gerais S.A.
EXPO	Exponent, Inc.
DHR	Danaher Corporation
TEAD	Teads B.V.
BSAC	Banco Santander-Chile
MOH	Molina Healthcare, Inc.
AME	AMETEK, Inc.
RDVT	Red Violet, Inc.
BKSY	BlackSky Technology Inc.
PTN	Palatin Technologies, Inc.
IPM	Intelligent Protection Management Corp.
LOB	Live Oak Bancshares, Inc.
BK	The Bank of New York Mellon Corporation
YAMHF	Yamaha Motor Co., Ltd.
ASAZF	ASSA ABLOY AB (publ)
TEM	Tempus AI, Inc.
AIRS	AirSculpt Technologies, Inc.
BYSI	BeyondSpring Inc.
ULTA	Ulta Beauty, Inc.
AIMFF	Aimia Inc.
CORZ	Core Scientific, Inc.
SBEV	Splash Beverage Group, Inc.
SPXC	SPX Technologies, Inc.
UMBF	UMB Financial Corporation
FL	Foot Locker, Inc.
FOX	Fox Corporation
LUMN	Lumen Technologies, Inc.
INOD	Innodata Inc.
VTR	Ventas, Inc.
PEP	PepsiCo, Inc.
BPOP	Popular, Inc.
UEIC	Universal Electronics Inc.
MDXG	MiMedx Group, Inc.
ORLY	O'Reilly Automotive, Inc.
SIGI	Selective Insurance Group, Inc.
THS	TreeHouse Foods, Inc.
NUMIF	Numinus Wellness Inc.
HMC	Honda Motor Co., Ltd.
SVV	Savers Value Village, Inc.
ANSLF	Ansell Limited
XRX	Xerox Holdings Corporation
BADFF	Badger Infrastructure Solutions Ltd.
TCMD	Tactile Systems Technology, Inc.
FWONA	Formula One Group
RIOT	Riot Platforms, Inc.
LCHTF	Text S.A.
NNOX	Nano-X Imaging Ltd.
MTRAF	Metro Inc.
ITT	ITT Inc.
AMADF	Amadeus IT Group, S.A.
SCKT	Socket Mobile, Inc.
MTEX	Mannatech, Incorporated
TX	Ternium S.A.
ZEPP	Zepp Health Corporation
UNP	Union Pacific Corporation
SBET	SharpLink Gaming Ltd.
SKHCF	Sonic Healthcare Limited
MA	Mastercard Incorporated
UPBD	Upbound Group, Inc.
DYN	Dyne Therapeutics, Inc.
IPW	iPower Inc.
TREE	LendingTree, Inc.
BEEM	Beam Global
MHH	Mastech Digital, Inc.
MTZ	MasTec, Inc.
CEG	Constellation Energy Corporation
FOXA	Fox Corporation
AEYE	AudioEye, Inc.
STKL	SunOpta Inc.
PM	Philip Morris International Inc.
BBWI	Bath & Body Works, Inc.
AESE	Allied Esports Entertainment Inc.
ALLE	Allegion plc
KVUE	Kenvue Inc.
REZI	Resideo Technologies, Inc.
AZREF	Azure Power Global Limited
KNX	Knight-Swift Transportation Holdings Inc.
SHLAF	Schindler Holding AG
HON	Honeywell International Inc.
ASM	Avino Silver & Gold Mines Ltd.
BNTX	BioNTech SE
GELYF	Geely Automobile Holdings Limited
CLPS	CLPS Incorporation
MTSI	MACOM Technology Solutions Holdings, Inc.
FR	First Industrial Realty Trust, Inc.
WTCHF	WiseTech Global Limited
MLNK	MeridianLink, Inc.
LAMR	Lamar Advertising Company
CIGI	Colliers International Group Inc.
TAL	TAL Education Group
ISRG	Intuitive Surgical, Inc.
JAGX	Jaguar Health, Inc.
CAG	Conagra Brands, Inc.
WHR	Whirlpool Corporation
DVAX	Dynavax Technologies Corporation
SEOJF	Stora Enso Oyj
AMAT	Applied Materials, Inc.
SID	Companhia Siderúrgica Nacional
WFC	Wells Fargo & Company
SMSMY	Sims Limited
PWR	Quanta Services, Inc.
THLEF	Thales S.A.
HFWA	Heritage Financial Corporation
WTRG	Essential Utilities, Inc.
CTIB	Yunhong CTI Ltd.
NHTC	Natural Health Trends Corp.
TSM	Taiwan Semiconductor Manufacturing Company Limited
SBUX	Starbucks Corporation
LYV	Live Nation Entertainment, Inc.
PBLA	Panbela Therapeutics, Inc.
FSBC	Five Star Bancorp
WCN	Waste Connections, Inc.
IDXX	IDEXX Laboratories, Inc.
T	AT&T Inc.
IDA	IDACORP, Inc.
BLDP	Ballard Power Systems Inc.
SGRP	SPAR Group, Inc.
VMC	Vulcan Materials Company
ATHM	Autohome Inc.
LNW	Light & Wonder, Inc.
ASO	Academy Sports and Outdoors, Inc.
IMUX	Immunic, Inc.
ARCT	Arcturus Therapeutics Holdings Inc.
GLT	Glatfelter Corporation
ADAP	Adaptimmune Therapeutics plc
NBTB	NBT Bancorp Inc.
THRM	Gentherm Incorporated
CGRN	Capstone Green Energy Corporation
DOMO	Domo, Inc.
SNMSF	Spin Master Corp.
SPIR	Spire Global, Inc.
ONTF	ON24, Inc.
AMKAF	A.P. Møller - Mærsk A/S
LITB	LightInTheBox Holding Co., Ltd.
TXRH	Texas Roadhouse, Inc.
OTGLF	CD Projekt S.A.
DD	DuPont de Nemours, Inc.
TOST	Toast, Inc.
PINE	Alpine Income Property Trust, Inc.
CERT	Certara, Inc.
CNO	CNO Financial Group, Inc.
FTRE	Fortrea Holdings Inc.
ASUR	Asure Software, Inc.
ALLO	Allogene Therapeutics, Inc.
NWSA	News Corporation
OMER	Omeros Corporation
MIND	MIND Technology, Inc.
CUBI	Customers Bancorp, Inc.
ADN	Advent Technologies Holdings, Inc.
GSHD	Goosehead Insurance, Inc
NWS	News Corporation
CSCCF	Capstone Copper Corp.
LUNMF	Lundin Mining Corporation
PDFS	PDF Solutions, Inc.
JFIN	Jiayin Group Inc.
DNOW	Dnow Inc.
PHUN	Phunware, Inc.
FI	Fiserv, Inc.
PMTS	CPI Card Group Inc.
RBRK	Rubrik, Inc.
EGLXF	Enthusiast Gaming Holdings Inc.
TWNK	Hostess Brands, Inc.
INSM	Insmed Incorporated
SAPIF	Saputo Inc.
TARS	Tarsus Pharmaceuticals, Inc.
BSX	Boston Scientific Corporation
PUBM	PubMatic, Inc.
ADSK	Autodesk, Inc.
CRDF	Cardiff Oncology, Inc.
RDCM	RADCOM Ltd.
SPCE	Virgin Galactic Holdings, Inc.
RTX	RTX Corporation
VMEO	Vimeo, Inc.
USDP	USD Partners LP
HG	Hamilton Insurance Group, Ltd.
CMPR	Cimpress plc
COO	The Cooper Companies, Inc.
ARRY	Array Technologies, Inc.
BWMX	Betterware de México, S.A.P.I. de C.V.
PUMP	ProPetro Holding Corp.
TRZBF	Transat A.T. Inc.
BBY	Best Buy Co., Inc.
BTRS	BTRS Holdings Inc.
TRST	TrustCo Bank Corp NY
WMG	Warner Music Group Corp.
NFYEF	NFI Group Inc.
WAL	Western Alliance Bancorporation
TRIP	Tripadvisor, Inc.
TSEM	Tower Semiconductor Ltd.
OTLK	Outlook Therapeutics, Inc.
CELC	Celcuity Inc.
DUFRY	Dufry AG
GTLB	GitLab Inc.
ACHR	Archer Aviation Inc.
AOMR	Angel Oak Mortgage, Inc.
CVLT	Commvault Systems, Inc.
ZION	Zions Bancorporation, National Association
VCYT	Veracyte, Inc.
KMPH	KemPharm, Inc.
WFRD	Weatherford International plc
VECO	Veeco Instruments Inc.
AEP	American Electric Power Company, Inc.
WLDN	Willdan Group, Inc.
APP	AppLovin Corporation
JAPAF	Japan Tobacco Inc.
GLPEF	Galp Energia, SGPS, S.A.
ACLLF	ATCO Ltd.
KOD	Kodiak Sciences Inc.
CATX	Perspective Therapeutics, Inc.
RELX	RELX Plc
MIGI	Mawson Infrastructure Group, Inc.
SNOW	Snowflake Inc.
LMT	Lockheed Martin Corporation
CMI	Cummins Inc.
JBL	Jabil Inc.
OTIS	Otis Worldwide Corporation
HSTM	HealthStream, Inc.
NTGR	NETGEAR, Inc.
EVA	Enviva Inc.
ELTK	Eltek Ltd.
AOIFF	Africa Oil Corp.
WATT	Energous Corporation
ABCL	AbCellera Biologics Inc.
CMCL	Caledonia Mining Corporation Plc
CSBR	Champions Oncology, Inc.
MIDD	The Middleby Corporation
EML	The Eastern Company
LEAT	Leatt Corporation
KLIC	Kulicke and Soffa Industries, Inc.
GDDY	GoDaddy Inc.
EVCM	EverCommerce Inc.
MHCUF	Flagship Communities Real Estate Investment Trust
SNA	Snap-on Incorporated
KNCRF	Konecranes Plc
APOG	Apogee Enterprises, Inc.
PIXY	ShiftPixy, Inc.
BOSSY	Hugo Boss AG
PARR	Par Pacific Holdings, Inc.
DPZUF	Domino's Pizza Enterprises Limited
AMWD	American Woodmark Corporation
OSAGF	OSRAM Licht AG
STAG	STAG Industrial, Inc.
WSO	Watsco, Inc.
GRMN	Garmin Ltd.
NGRRF	Nagarro SE
LEVI	Levi Strauss & Co.
ETWO	E2open Parent Holdings, Inc.
MASI	Masimo Corporation
DAR	Darling Ingredients Inc.
EYEN	Eyenovia, Inc.
MDU	MDU Resources Group, Inc.
VRCA	Verrica Pharmaceuticals Inc.
IPWR	Ideal Power Inc.
GSBD	Goldman Sachs BDC, Inc.
VICR	Vicor Corporation
CME	CME Group Inc.
PATK	Patrick Industries, Inc.
JELD	JELD-WEN Holding, Inc.
BCCLF	Becle, S.A.B. de C.V.
VWAGY	Volkswagen AG
BTVCF	Britvic plc
GGG	Graco Inc.
AEHR	Aehr Test Systems
ACN	Accenture plc
RSKD	Riskified Ltd.
GNS	Genius Group Limited
PRVA	Privia Health Group, Inc.
AIM	AIM ImmunoTech Inc.
TT	Trane Technologies plc
MGNI	Magnite, Inc.
TE	T1 Energy Inc
ECPG	Encore Capital Group, Inc.
RLXXF	RELX Plc
EMBVF	Arca Continental, S.A.B. de C.V.
WALD	Waldencast plc
AMSF	AMERISAFE, Inc.
ECOR	electroCore, Inc.
NAGE	Niagen Bioscience Inc
FLEX	Flex Ltd.
ARM	Arm Holdings plc American Depositary Shares
NSIT	Insight Enterprises, Inc.
TRAK	ReposiTrak, Inc.
GMAB	Genmab A/S
LEDS	SemiLEDs Corporation
MKGAF	MERCK Kommanditgesellschaft auf Aktien
UGI	UGI Corporation
EQH	Equitable Holdings, Inc.
LEA	Lear Corporation
BERY	Berry Global Group, Inc.
CTRE	CareTrust REIT, Inc.
MCB	Metropolitan Bank Holding Corp.
WDAY	Workday, Inc.
SNAL	Snail, Inc. Class A Common Stock
IOSP	Innospec Inc.
PROC	Procaps Group S.A.
JBI	Janus International Group, Inc.
STEP	StepStone Group Inc.
CALX	Calix, Inc.
SCL	Stepan Company
AGIO	Agios Pharmaceuticals, Inc.
COHR	Coherent, Inc.
PHGE	BiomX Inc.
CXM	Sprinklr, Inc.
EGBN	Eagle Bancorp, Inc.
ALLY	Ally Financial Inc.
BF-B	Brown-Forman Corporation
AMPL	Amplitude, Inc.
SLND	Southland Holdings, Inc.
ARAY	Accuray Incorporated
DITHF	DS Smith Plc
EDUC	Educational Development Corporation
FIX	Comfort Systems USA, Inc.
KRO	Kronos Worldwide, Inc.
TOVX	Theriva Biologics, Inc.
NWL	Newell Brands Inc.
SEE	Sealed Air Corporation
TAC	TransAlta Corporation
IRM	Iron Mountain Incorporated
VNT	Vontier Corporation
CHDN	Churchill Downs Incorporated
GLCNF	Glencore plc
DBVT	DBV Technologies S.A.
CPK	Chesapeake Utilities Corporation
EVRG	Evergy, Inc.
HSDT	Helius Medical Technologies, Inc.
UAA	Under Armour, Inc.
DRI	Darden Restaurants, Inc.
CZMWF	Carl Zeiss Meditec AG
DRS	Leonardo DRS, Inc.
SPT	Sprout Social, Inc.
PSMT	PriceSmart, Inc.
ROST	Ross Stores, Inc.
SEMR	Semrush Holdings, Inc.
PRRWF	Park Lawn Corporation
NOVT	Novanta Inc.
NVYTF	Novacyt S.A.
CARA	Cara Therapeutics, Inc.
HUMA	Humacyte, Inc.
OESX	Orion Energy Systems, Inc.
JHX	James Hardie Industries plc
FRHLF	Freehold Royalties Ltd.
AEVA	Aeva Technologies, Inc.
MMC	Marsh & McLennan Companies, Inc.
ZRSEF	DocMorris AG
DGII	Digi International Inc.
AMBA	Ambarella, Inc.
ASH	Ashland Inc.
CNX	CNX Resources Corporation
SHFS	SHF Holdings, Inc.
RPD	Rapid7, Inc.
ORN	Orion Group Holdings, Inc.
ERIE	Erie Indemnity Company
SPXCF	Singapore Exchange Limited
COHU	Cohu, Inc.
GEO	The GEO Group, Inc.
DBI	Designer Brands Inc.
EPRT	Essential Properties Realty Trust, Inc.
MANH	Manhattan Associates, Inc.
TAP	Molson Coors Beverage Company
SHO	Sunstone Hotel Investors, Inc.
ABEO	Abeona Therapeutics Inc.
ITI	Iteris, Inc.
AROC	Archrock, Inc.
NXT	Nextracker Inc.
ONCY	Oncolytics Biotech Inc.
LFC	China Life Insurance Company Limited
SBSI	Southside Bancshares, Inc.
NICE	NICE Ltd.
CNXC	Concentrix Corporation
PHG	Koninklijke Philips N.V.
VTYX	Ventyx Biosciences, Inc.
NISN	Nisun International Enterprise Development Group Co., Ltd
NTLA	Intellia Therapeutics, Inc.
NMFC	New Mountain Finance Corporation
PRIM	Primoris Services Corporation
OXBR	Oxbridge Re Holdings Limited
CXW	CoreCivic, Inc.
SSYS	Stratasys Ltd.
SEI	Solaris Energy Infrastructure, Inc.
GALT	Galectin Therapeutics Inc.
AOUT	American Outdoor Brands, Inc.
GPC	Genuine Parts Company
NXPI	NXP Semiconductors N.V.
LWSCF	Sienna Senior Living Inc.
ECRAF	Ecora Resources PLC
MBT	Mobile TeleSystems Public Joint Stock Company
STE	STERIS plc
OKTA	Okta, Inc.
XPRO	Expro Group Holdings N.V.
ANFGF	Antofagasta plc
VC	Visteon Corporation
ORGO	Organogenesis Holdings Inc.
PAR	PAR Technology Corporation
RNG	RingCentral, Inc.
BBAR	Banco BBVA Argentina S.A.
HNRG	Hallador Energy Company
INO	Inovio Pharmaceuticals, Inc.
OS	OneStream, Inc. Class A Common Stock
GDRX	GoodRx Holdings, Inc.
OSPN	OneSpan Inc.
WAT	Waters Corporation
FICO	Fair Isaac Corporation
ETHC.NE	Ether Capital Corporation
PCYO	Pure Cycle Corporation
HL	Hecla Mining Company
W	Wayfair Inc.
LAWS	Lawson Products, Inc.
PONY	Pony AI Inc. American Depositary Shares
PNFP	Pinnacle Financial Partners, Inc.
FRME	First Merchants Corporation
GMS	GMS Inc.
PNTG	The Pennant Group, Inc.
GAP	The Gap, Inc.
DDEJF	Dundee Corporation
GLDD	Great Lakes Dredge & Dock Corporation
SBT	Sterling Bancorp, Inc.
OSIS	OSI Systems, Inc.
ARES	Ares Management Corporation
HIMX	Himax Technologies, Inc.
LARK	Landmark Bancorp, Inc.
KGEI	Kolibri Global Energy Inc.
KTB	Kontoor Brands, Inc.
TRNS	Transcat, Inc.
LSXMK	The Liberty SiriusXM Group
AIZ	Assurant, Inc.
TXT	Textron Inc.
LAND	Gladstone Land Corporation
IHS	IHS Holding Limited
ICL	ICL Group Ltd
MRCY	Mercury Systems, Inc.
XBIT	XBiotech Inc.
ABCB	Ameris Bancorp
TFC	Truist Financial Corporation
WTW	Willis Towers Watson Public Limited Company
EVER	EverQuote, Inc.
ROIV	Roivant Sciences Ltd.
SRRK	Scholar Rock Holding Corporation
RPRX	Royalty Pharma plc
QXO	QXO Inc
NMRA	Neumora Therapeutics, Inc. Common Stock
TILE	Interface, Inc.
MWA	Mueller Water Products, Inc.
LCII	LCI Industries
CLB	Core Laboratories N.V.
IFF	International Flavors & Fragrances Inc.
WSM	Williams-Sonoma, Inc.
RVLV	Revolve Group, Inc.
SLP	Simulations Plus, Inc.
IMPUY	Impala Platinum Holdings Limited
TPX	Tempur Sealy International, Inc.
EKSO	Ekso Bionics Holdings, Inc.
ETN	Eaton Corporation plc
SPWH	Sportsman's Warehouse Holdings, Inc.
GLBE	Global-e Online Ltd.
PETV	PetVivo Holdings, Inc.
SOLV	Solventum Corporation
MAMA	Mama's Creations, Inc.
FTCI	FTC Solar, Inc.
PODD	Insulet Corporation
STBMF	St Barbara Limited
WSBC	WesBanco, Inc.
OCFC	OceanFirst Financial Corp.
RBA	RB Global, Inc.
ACFN	Acorn Energy, Inc.
QCRH	QCR Holdings, Inc.
LVMHF	LVMH Moët Hennessy - Louis Vuitton, Société Européenne
FMS	Fresenius Medical Care AG & Co. KGaA
PRSU	Pursuit Attractions and Hospitality, Inc.
ARE	Alexandria Real Estate Equities, Inc.
AVDX	AvidXchange Holdings, Inc.
TRI	Thomson Reuters Corporation
ZEUS	Olympic Steel, Inc.
GCI	Gannett Co., Inc.
EQX	Equinox Gold Corp.
EYPT	EyePoint Pharmaceuticals, Inc.
NUTX	Nutex Health, Inc.
TRMK	Trustmark Corporation
AMPG	AmpliTech Group, Inc.
SRRTF	Slate Grocery REIT
L	Loews Corporation
NRXP	NRx Pharmaceuticals, Inc.
SRAD	Sportradar Group AG
LAZ	Lazard Ltd
TZOO	Travelzoo
ZG	Zillow Group, Inc. Class A
FRT	Federal Realty Investment Trust
WRB	W. R. Berkley Corporation
GWH	ESS Tech, Inc.
AUDC	AudioCodes Ltd.
BHLB	Berkshire Hills Bancorp, Inc.
ITOS	iTeos Therapeutics, Inc.
WSFS	WSFS Financial Corporation
PPBI	Pacific Premier Bancorp, Inc.
GTY	Getty Realty Corp.
QRVO	Qorvo, Inc.
ZBRA	Zebra Technologies Corporation
PAAS	Pan American Silver Corp.
MAA	Mid-America Apartment Communities, Inc.
XRAY	DENTSPLY SIRONA Inc.
IMKTA	Ingles Markets, Incorporated
TH	Target Hospitality Corp.
CCRD	CoreCard Corporation
AN	AutoNation, Inc.
TBI	TrueBlue, Inc.
AVGO	Broadcom Inc.
TPC	Tutor Perini Corporation
WH	Wyndham Hotels & Resorts, Inc.
A	Agilent Technologies, Inc.
WEST	Westrock Coffee Company, LLC
VYNE	VYNE Therapeutics Inc.
EGHT	8x8, Inc.
EZPW	EZCORP, Inc.
GRFS	Grifols, S.A.
CMT	Core Molding Technologies, Inc.
BHE	Benchmark Electronics, Inc.
SKLZ	Skillz Inc.
KLPEF	Klépierre
FOUR	Shift4 Payments, Inc.
TEL	TE Connectivity Ltd.
BCLI	Brainstorm Cell Therapeutics Inc.
PILBF	Pilbara Minerals Limited
FBIZ	First Business Financial Services, Inc.
SFIX	Stitch Fix, Inc.
FEAM	5E Advanced Materials Inc.
INBS	Intelligent Bio Solutions Inc.
CEVA	CEVA, Inc.
KOP	Koppers Holdings Inc.
GEN	Gen Digital Inc.
MITQ	Moving iMage Technologies, Inc.
CACI	CACI International Inc
FLUT	Flutter Entertainment plc
INTT	inTEST Corporation
ITRI	Itron, Inc.
FC	Franklin Covey Co.
ITUB	Itaú Unibanco Holding S.A.
JOB	GEE Group, Inc.
FLNG	FLEX LNG Ltd.
AOSL	Alpha and Omega Semiconductor Limited
AGFMF	AGF Management Limited
ARMN	Aris Mining Corporation
SCYX	SCYNEXIS, Inc.
HUT	Hut 8 Corp.
PAYC	Paycom Software, Inc.
ADNT	Adient plc
CYN	Cyngn Inc.
GLMD	Galmed Pharmaceuticals Ltd.
CLDX	Celldex Therapeutics, Inc.
KYMR	Kymera Therapeutics, Inc.
STM	STMicroelectronics N.V.
HAL	Halliburton Company
DXR	Daxor Corporation
BWMN	Bowman Consulting Group Ltd.
LTBR	Lightbridge Corporation
LEU	Centrus Energy Corp.
ROCK	Gibraltar Industries, Inc.
EME	EMCOR Group, Inc.
NOC	Northrop Grumman Corporation
ATLKY	Atlas Copco AB
VRA	Vera Bradley, Inc.
OOMA	Ooma, Inc.
EBC	Eastern Bankshares, Inc.
MATX	Matson, Inc.
RILY	B. Riley Financial, Inc.
ITRN	Ituran Location and Control Ltd.
CHRRF	Chorus Aviation Inc.
SBGI	Sinclair, Inc.
TATT	TAT Technologies Ltd.
SEPJF	Spectris plc
KOPN	Kopin Corporation
RGLD	Royal Gold, Inc.
CUB	Lionheart Holdings
KRYS	Krystal Biotech, Inc.
ASTE	Astec Industries, Inc.
SLM	SLM Corporation
CLMB	Climb Global Solutions, Inc.
SQ	Block, Inc.
BJ	BJ's Wholesale Club Holdings, Inc.
IBTA	Ibotta, Inc.
PAYX	Paychex, Inc.
PRM	Perimeter Solutions, S.A.
PERI	Perion Network Ltd.
EHAB	Enhabit, Inc.
INTU	Intuit Inc.
VREX	Varex Imaging Corporation
CPIX	Cumberland Pharmaceuticals Inc.
BLBX	Blackboxstocks Inc.
AQST	Aquestive Therapeutics, Inc.
SYBX	Synlogic, Inc.
IDEXY	Industria de Diseño Textil, S.A.
INSG	Inseego Corp.
RGEN	Repligen Corporation
PBH	Prestige Consumer Healthcare Inc.
RAIN	Rain Enhancement Technologies Holdco Inc
FTEK	Fuel Tech, Inc.
BCC	Boise Cascade Company
STBA	S&T Bancorp, Inc.
HAFC	Hanmi Financial Corporation
SWKS	Skyworks Solutions, Inc.
RLX	RLX Technology Inc.
PRA	ProAssurance Corporation
RNMBF	Rheinmetall AG
MTUAF	MTU Aero Engines AG
BBW	Build-A-Bear Workshop, Inc.
KGHPF	KGHM Polska Miedz S.A.
GMBL	Esports Entertainment Group, Inc.
HKMPF	Hikma Pharmaceuticals PLC
HYW	Hywin Holdings Ltd.
LIEN	Chicago Atlantic BDC, Inc.
ELS	Equity LifeStyle Properties, Inc.
AMGN	Amgen Inc.
WEX	WEX Inc.
SYRA	Syra Health Corp. Class A Common Stock
CGNT	Cognyte Software Ltd.
LMB	Limbach Holdings, Inc.
CSW	CSW Industrials, Inc.
WTS	Watts Water Technologies, Inc.
NBIS	Nebius Group N.V.
MMYT	MakeMyTrip Limited
TBCH	Turtle Beach Corporation
NWBI	Northwest Bancshares, Inc.
RSSS	Research Solutions, Inc.
OFS	OFS Capital Corporation
ORRF	Orrstown Financial Services, Inc.
SAND	Sandstorm Gold Ltd.
PCAR	PACCAR Inc
AYRO	Ayro, Inc.
OZK	Bank OZK
SLI	Standard Lithium Ltd.
LNN	Lindsay Corporation
HZO	MarineMax, Inc.
PESI	Perma-Fix Environmental Services, Inc.
PRTH	Priority Technology Holdings, Inc.
BRAG	Bragg Gaming Group Inc.
KMI	Kinder Morgan, Inc.
BAP	Credicorp Ltd.
SFRRF	Sandfire Resources Limited
STLD	Steel Dynamics, Inc.
FGEN	FibroGen, Inc.
RCKY	Rocky Brands, Inc.
ACNT	Ascent Industries Co.
SLDB	Solid Biosciences Inc.
HOMB	Home Bancshares, Inc.
LGCY	Legacy Education Inc.
SY	So-Young International Inc.
TCBI	Texas Capital Bancshares, Inc.
PECO	Phillips Edison & Company, Inc.
TFSL	TFS Financial Corporation
STEL	Stellar Bancorp, Inc.
VERX	Vertex, Inc.
TOMZ	TOMI Environmental Solutions, Inc.
KDP	Keurig Dr Pepper Inc.
MSCI	MSCI Inc.
TWIN	Twin Disc, Incorporated
WW	WW International, Inc.
CARG	CarGurus, Inc.
WOOF	Petco Health and Wellness Company, Inc.
FRST	Primis Financial Corp.
LFVN	LifeVantage Corporation
VIAV	Viavi Solutions Inc.
PPRQF	Choice Properties Real Estate Investment Trust
QVCGA	QVC Group Inc.
LFCR	Lifecore Biomedical, Inc.
CIFR	Cipher Mining Inc.
WTFC	Wintrust Financial Corporation
RYAM	Rayonier Advanced Materials Inc.
XPEL	XPEL, Inc.
IMNN	Imunon, Inc.
CBZ	CBIZ, Inc.
CW	Curtiss-Wright Corporation
MDAI	Spectral AI, Inc.
ITRG	Integra Resources Corp.
GSAT	Globalstar, Inc.
GECFF	Gecina S.A.
GOLF	Acushnet Holdings Corp.
HTOO	Fusion Fuel Green PLC
HSON	Hudson Global, Inc.
IIIV	i3 Verticals, Inc.
NOA	North American Construction Group Ltd.
PENN	PENN Entertainment, Inc.
INFU	InfuSystem Holdings, Inc.
MEDXF	Medexus Pharmaceuticals Inc.
RFIL	RF Industries, Ltd.
SII	Sprott Inc.
KTOS	Kratos Defense & Security Solutions, Inc.
NGVT	Ingevity Corporation
REPX	Riley Exploration Permian, Inc.
CRL	Charles River Laboratories International, Inc.
EM	Smart Share Global Limited
SMBC	Southern Missouri Bancorp, Inc.
NPWR	NET Power Inc.
OGN	Organon & Co.
AORT	Artivion, Inc.
CAH	Cardinal Health, Inc.
TG	Tredegar Corporation
VBNK	VersaBank
ARR	ARMOUR Residential REIT, Inc.
ANGO	AngioDynamics, Inc.
ICCM	IceCure Medical Ltd
DNB	Dun & Bradstreet Holdings, Inc.
DASTY	Dassault Systèmes SE
MOVE	Movano Inc.
BRDCY	Bridgestone Corporation
MMLP	Martin Midstream Partners L.P.
WILC	G. Willi-Food International Ltd.
SSKN	STRATA Skin Sciences, Inc.
TMSNY	Temenos AG
MZTI	The Marzetti Company
TXN	Texas Instruments Incorporated
DXPE	DXP Enterprises, Inc.
SOUHY	South32 Limited
DRRX	DURECT Corporation
MTLS	Materialise N.V.
DTEGY	Deutsche Telekom AG
BLIN	Bridgeline Digital, Inc.
CWRK	CurrencyWorks Inc.
MVST	Microvast Holdings, Inc.
DUK	Duke Energy Corporation
CINT	CI&T Inc
SPFI	South Plains Financial, Inc.
BZAI	Blaize Holdings, Inc.
LVS	Las Vegas Sands Corp.
EXOD	Exodus Movement, Inc.
HESAY	Hermès International Société en commandite par actions
MGA	Magna International Inc.
INGN	Inogen, Inc.
SPH	Suburban Propane Partners, L.P.
NRXS	NeurAxis, Inc.
EGFEY	Eurobank Ergasias Services and Holdings S.A.
KALA	Kala Pharmaceuticals, Inc.
JYNT	The Joint Corp.
PLL	Piedmont Lithium Inc.
SIEGY	Siemens AG
TGEN	Tecogen Inc.
MIELY	Mitsubishi Electric Corporation
SWRAY	Swire Pacific Limited
DDI	DoubleDown Interactive Co., Ltd.
TCEHY	Tencent Holdings Limited
PDSB	PDS Biotechnology Corporation
FSI	Flexible Solutions International, Inc.
VTSI	VirTra, Inc.
CMRE	Costamare Inc.
MYFW	First Western Financial, Inc.
AWK	American Water Works Company, Inc.
FTFT	Future FinTech Group Inc.
ESLT	Elbit Systems Ltd.
BVNKF	Bavarian Nordic A/S
TUSK	Mammoth Energy Services, Inc.
DIBS	1stdibs.Com, Inc.
ADV	Advantage Solutions Inc.
DEA	Easterly Government Properties, Inc.
SSD	Simpson Manufacturing Co., Inc.
SUUIF	Superior Plus Corp.
LTC	LTC Properties, Inc.
DANOY	Danone S.A.
MHVYF	Mitsubishi Heavy Industries, Ltd.
CBD	Companhia Brasileira de Distribuição
GOFPY	Organization of Football Prognostics S.A.
MTYFF	MTY Food Group Inc.
IIIN	Insteel Industries, Inc.
AVAL	Grupo Aval Acciones y Valores S.A.
GTBIF	Green Thumb Industries Inc.
PAYS	PaySign, Inc.
NOPMF	Neo Performance Materials Inc.
CHRD	Chord Energy Corporation
INBK	First Internet Bancorp
NKLA	Nikola Corporation
AGESF	ageas SA/NV
XTIA	XTI Aerospace, Inc.
AUD	Audacy, Inc.
TOELY	Tokyo Electron Limited
RIME	Algorhythm Holdings, Inc.
NSRGY	Nestlé S.A.
GOTU	Gaotu Techedu Inc.
KNDI	Kandi Technologies Group, Inc.
MPTI	M-tron Industries, Inc.
CAKE	The Cheesecake Factory Incorporated
BDNNY	Boliden AB (publ)
SVC	Service Properties Trust
GWLIF	Great-West Lifeco Inc.
CRNC	Cerence Inc.
ONEXF	Onex Corporation
BESIY	BE Semiconductor Industries N.V.
TPB	Turning Point Brands, Inc.
DBD	Diebold Nixdorf, Incorporated
PLSE	Pulse Biosciences, Inc.
BTLCY	British Land Company Plc
SGC	Superior Group of Companies, Inc.
RWEOY	Rwe AG
VPG	Vishay Precision Group, Inc.
IHG	InterContinental Hotels Group PLC
NNI	Nelnet, Inc.
LND	BrasilAgro - Companhia Brasileira de Propriedades Agrícolas
PUBGY	Publicis Groupe S.A.
SSTI	SoundThinking, Inc.
CTGO	Contango Ore, Inc.
CXAI	CXApp Inc.
TTDKY	TDK Corporation
LSTA	Lisata Therapeutics, Inc.
SKFRY	AB SKF (publ)
QUBT	Quantum Computing, Inc.
PSEC	Prospect Capital Corporation
CLPHY	CLP Holdings Limited
SMTGF	SMA Solar Technology AG
ENTX	Entera Bio Ltd.
ACLS	Axcelis Technologies, Inc.
NHYDY	Norsk Hydro ASA
VTGN	VistaGen Therapeutics, Inc.
SFBS	ServisFirst Bancshares, Inc.
PTMN	Portman Ridge Finance Corporation
GHM	Graham Corporation
IFS	Intercorp Financial Services Inc.
DTNOF	Dno Asa
BCAB	BioAtla, Inc.
ACLLY	Accelleron Industries AG
MGRM	Monogram Orthopaedics, Inc.
NRDBY	Nordea Bank Abp
TTSH	Tile Shop Holdings, Inc.
ABBNY	ABB Ltd
SDZNY	Sandoz Group AG
ZURVY	Zurich Insurance Group AG
IVPAF	Ivanhoe Mines Ltd.
TVRD	Tvardi Therapeutics, Inc.
IGIFF	IGM Financial Inc.
PCSA	Processa Pharmaceuticals, Inc.
TURN	180 Degree Capital Corp.
GRWG	GrowGeneration Corp.
SFTBY	SoftBank Group Corp.
OFSTF	Carbon Streaming Corporation
ESLOF	EssilorLuxottica S.A.
SSY	SunLink Health Systems, Inc.
MSM	MSC Industrial Direct Co., Inc.
CSLLY	CSL Limited
SMEGF	Siemens Energy AG
FUN	Six Flags Entertainment Corporation
WINT	Windtree Therapeutics, Inc.
TMC	TMC the metals company Inc.
RMNI	Rimini Street, Inc.
MHO	M/I Homes, Inc.
KNW	Know Labs, Inc.
ATGN	Altigen Communications, Inc.
NABZY	National Australia Bank Limited
CYCC	Cyclacel Pharmaceuticals, Inc.
BH	Biglari Holdings Inc.
ACU	Acme United Corporation
HCHDF	Hochschild Mining plc
TLTZF	Tele2 AB (publ)
LNXSF	Lanxess AG
TMOAF	TomTom N.V.
RLGT	Radiant Logistics, Inc.
CBH	Virtus Convertible & Income 2024 Target Term Fund
TELNY	Telenor ASA
PWCDF	Power Corporation of Canada
NTR	Nutrien Ltd.
HENKY	Henkel AG & Co. KGaA
KLBAY	Klabin S.A.
BMBLF	Brambles Limited
UTRS	Minerva Surgical, Inc.
CPHI	China Pharma Holdings, Inc.
IFNNY	Infineon Technologies AG
AXAHY	Axa S.A.
LNSR	LENSAR, Inc.
PROSY	Prosus N.V.
ATZAF	Aritzia Inc.
CCDBF	CCL Industries Inc.
TMTNF	Toromont Industries Ltd.
CDPYF	Canadian Apartment Properties Real Estate Investment Trust
INPOY	InPost S.A.
AGGZF	Ag Growth International Inc.
RHEP	Regional Health Properties, Inc.
ZIMV	ZimVie Inc.
OCPNF	Olympus Corporation
UTSI	UTStarcom Holdings Corp.
SMGZY	Smiths Group plc
ADDYY	adidas AG
SCMWY	Swisscom AG
EGIEY	Engie Brasil Energia S.A.
TMRAY	Tomra Systems ASA
NG	NovaGold Resources Inc.
SCBFF	Standard Chartered PLC
UNCFF	UniCredit S.p.A.
SYIEF	Symrise AG
STRT	Strattec Security Corporation
TFIN	Triumph Financial, Inc.
TRUMF	Terumo Corporation
TTD	The Trade Desk, Inc.
AIQUF	L'Air Liquide S.A.
RHE	Regional Health Properties, Inc.
NWVCF	EnWave Corporation
VACNY	VAT Group AG
ELTP	Elite Pharmaceuticals, Inc.
EXCOF	Exco Technologies Limited
GEODF	Geodrill Limited
NXST	Nexstar Media Group, Inc.
ULCC	Frontier Group Holdings, Inc.
LSF	Laird Superfood, Inc.
MGDDF	Compagnie Générale des Établissements Michelin Société en commandite par actions
NTOIF	Neste Oyj
DTEGF	Deutsche Telekom AG
SVYSF	Solvay S.A.
PMCUF	Pro Medicus Limited
DPSTF	Deutsche Post AG
QNTQF	QinetiQ Group plc
PI	Impinj, Inc.
HTLZF	Hamilton Thorne Ltd.
CESDF	CES Energy Solutions Corp.
SWZCF	Swisscom AG
ILKAF	Iluka Resources Limited
MCHOY	MultiChoice Group Limited
DVN	Devon Energy Corporation
MLSPF	Melrose Industries PLC
INLX	Intellinetics, Inc.
SCSC	ScanSource, Inc.
RNA	Avidity Biosciences, Inc.
AACAY	AAC Technologies Holdings Inc.
WHG	Westwood Holdings Group, Inc.
AVVIY	Aviva plc
GNGBF	Getinge AB (publ)
BIOYF	BioSyent Inc.
BIOVF	Swedish Orphan Biovitrum AB (publ)
MPNGF	Meituan
HRNNF	Hydro One Limited
RCRT	Recruiter.com Group, Inc.
UNPRF	Uniper SE
DRETF	Dream Office Real Estate Investment Trust
QBCRF	Quebecor Inc.
DSDVF	Dsv A/S
EVSBY	EVS Broadcast Equipment S.A.
BFLBF	Bilfinger SE
NARI	Inari Medical, Inc.
KMBIF	Kambi Group plc
DTSRF	Ether Capital Corporation
LEGIF	LEG Immobilien SE
VIEW	View, Inc.
BRRAY	Barloworld Limited
IDWM	IDW Media Holdings, Inc.
PDLMF	Petra Diamonds Limited
PRYMF	Prysmian S.p.A.
HRT	HireRight Holdings Corporation
ROYMF	International Distributions Services plc
SPPJY	Sappi Limited
BTGOF	BT Group plc
HRGLF	Hargreaves Lansdown plc
RTMVF	Rightmove plc
GLAPF	Glanbia plc
IFNNF	Infineon Technologies AG
CWSRF	Chartwell Retirement Residences
TTBXF	Tritax Big Box REIT plc
GBLI	Global Indemnity Group, LLC
CWSFF	Cielo Waste Solutions Corp.
VLD	Velo3D, Inc.
YAMCF	Yamaha Corporation
SEAT	Vivid Seats Inc.
SOWG	Sow Good Inc.
CLZNF	Clariant AG
OCANF	OceanaGold Corporation
GEAGF	GEA Group AG
WOLWF	Woolworths Group Limited
HCMLF	Holcim Ltd
IMDX	Insight Molecular Diagnostics Inc.
CISS	C3is Inc.
ELVA	Electrovaya Inc.
PVCT	Provectus Biopharmaceuticals, Inc.
RUSMF	Russel Metals Inc.
JUBPF	Jubilee Metals Group PLC
TIOG	Tingo Group, Inc.
APPEF	Appen Limited
SCTBF	Securitas AB (publ)
ANCTF	Alimentation Couche-Tard Inc.
ELKMF	Gold Road Resources Limited
SFES	Safeguard Scientifics, Inc.
DIIBF	Dorel Industries Inc.
EVTZF	Evertz Technologies Limited
VOLAF	AB Volvo (publ)
SDVKY	Sandvik AB (publ)
PTOAF	Pieridae Energy Limited
BCKIF	Babcock International Group PLC
APTO	Aptose Biosciences Inc.
PZRIF	Pizza Pizza Royalty Corp.
LIVE	Live Ventures Incorporated
AJINY	Ajinomoto Co., Inc.
AMLX	Amylyx Pharmaceuticals, Inc.
PPRUF	Kering S.A.
APLE	Apple Hospitality REIT, Inc.
FTHM	Fathom Holdings Inc.
PIAGF	Piaggio & C. S.p.A.
CMBT	Cmb.Tech N.V.
QMCI	QuoteMedia, Inc.
BAINF	BASE, Inc.
IDGBF	Indigo Books & Music Inc.
DNSKF	Danske Bank A/S
MATV	Mativ Holdings, Inc.
688235.SS	BeiGene, Ltd.
HWDJF	Howden Joinery Group Plc
ARNGF	Argonaut Gold Inc.
ISMAF	Indra Sistemas, S.A.
AENT	Alliance Entertainment Holding Corporation
BRDCF	Bridgestone Corporation
ACOPF	The a2 Milk Company Limited
BHIL	Benson Hill, Inc.
VZIO	VIZIO Holding Corp.
LZ	LegalZoom.com, Inc.
SGLFF	SGL Carbon SE
DINRF	SCREEN Holdings Co., Ltd.
IFPJF	Informa plc
SIETY	D'Ieteren Group S.A.
EZFL	EZFill Holdings Inc.
GEGYF	Genel Energy plc
ADWPF	Andrew Peller Limited
BRBOF	Brembo S.p.A.
CDOR	Condor Hospitality Trust, Inc.
CDNTF	Canadian Tire Corporation, Limited
APEUF	Atlas Engineered Products Ltd.
IRET	iREIT - MarketVector Quality REIT Index ETF
USAP	Universal Stainless & Alloy Products, Inc.
MTEK	Maris-Tech Ltd.
KGSPF	Kingspan Group plc
ALVR	AlloVir, Inc.
CROX	Crocs, Inc.
NEWT	Newtek Business Services Corp.
SQFT	Presidio Property Trust, Inc.
TORXF	Torex Gold Resources Inc.
ALV	Autoliv, Inc.
YUGVF	YouGov plc
GPRK	GeoPark Limited
HXGBF	Hexagon AB (publ)
VONOY	Vonovia SE
ARC	ARC Document Solutions, Inc.
SYZLF	Sylogist Ltd.
AMIVF	Atrium Mortgage Investment Corporation
EBR	Centrais Elétricas Brasileiras S.A. - Eletrobrás
NTTDF	NTT DATA Corporation
EMBC	Embecta Corp.
CWD	CaliberCos Inc.
HBM	Hudbay Minerals Inc.
RANI	Rani Therapeutics Holdings, Inc.
WDH	Waterdrop Inc.
GOEV	Canoo Inc.
ME	23andMe Holding Co.
CWXZF	Doman Building Materials Group Ltd.
NEPH	Nephros, Inc.
GDDFF	Goodfood Market Corp.
FRRVF	Ferrovial, S.A.
RYAN	Ryan Specialty Holdings, Inc.
FFAI	Faraday Future Intelligent Electric Inc.
AMT	American Tower Corporation
VLPNF	Voestalpine AG
IMCC	IM Cannabis Corp.
LEGN	Legend Biotech Corporation
WBEV	Winc, Inc.
PBR	Petróleo Brasileiro S.A. - Petrobras
KHOTF	Kahoot! ASA
CONE	CyrusOne Inc.
ATMU	Atmus Filtration Technologies Inc.
IFSPF	Interfor Corporation
RCM	R1 RCM Inc.
FOSUF	Fosun International Limited
IPSOF	Ipsos S.A.
FLYLF	FLYHT Aerospace Solutions Ltd.
QTRX	Quanterix Corporation
JRVMF	Jervois Global Limited
AAVMY	ABN AMRO Bank N.V.
KL	Kirkland Lake Gold Ltd.
IQEPF	IQE plc
CTKYY	CooTek (Cayman) Inc.
EVC	Entravision Communications Corporation
AFRAF	Air France-KLM S.A.
NPIFF	Northland Power Inc.
HEPS	D-Market Elektronik Hizmetler ve Ticaret A.S.
LTHM	Livent Corporation
YI	111, Inc.
MSDL	Morgan Stanley Direct Lending Fund
CMCM	Cheetah Mobile Inc.
ICLTF	GreenFirst Forest Products Inc.
AWCMF	Alumina Limited
CHALF	Chalice Brands Ltd.
DPSI	Decisionpoint Systems, Inc.
JJSF	J&J Snack Foods Corp.
GDYN	Grid Dynamics Holdings, Inc.
FPRUF	Fraport AG
CENN	Cenntro Electric Group Limited
DHLGY	Deutsche Post AG
BTCY	Biotricity, Inc.
GOCO	GoHealth, Inc.
WMT	Walmart Inc.
CLLKF	BICO Group AB (publ)
WKEY	WISeKey International Holding AG
LTM	LATAM Airlines Group S.A.
EVAX	Evaxion Biotech A/S
BIRK	Birkenstock Holding plc
TRTX	TPG RE Finance Trust, Inc.
MBGAF	Mercedes-Benz Group AG
FIF	First Trust Energy Infrastructure Fund
SOMMY	Sumitomo Chemical Company, Limited
WMS	Advanced Drainage Systems, Inc.
BKI	Black Knight, Inc.
TFFP	TFF Pharmaceuticals, Inc.
WLMS	Williams Industrial Services Group Inc.
NMM	Navios Maritime Partners L.P.
KAMN	Kaman Corporation
WAVE	Eco Wave Power Global AB (publ)
CNVVF	ConvaTec Group Plc
REPYY	Repsol, S.A.
TD	The Toronto-Dominion Bank
SMLR	Semler Scientific, Inc.
ALLG	Allego N.V.
CRZBF	Commerzbank AG
MRNA	Moderna, Inc.
GNLN	Greenlane Holdings, Inc.
PATI	Patriot Transportation Holding, Inc.
CRRFY	Carrefour S.A.
ESCA	Escalade, Incorporated
NM	Navios Maritime Holdings Inc.
PWP	Perella Weinberg Partners
AMPX	Amprius Technologies, Inc.
KSFTF	Kingsoft Corporation Limited
OUKPF	Metso Oyj
NH	NantHealth, Inc.
INCY	Incyte Corporation
BDRBF	Bombardier Inc.
ORKLY	Orkla ASA
AMS	American Shared Hospital Services
MPW	Medical Properties Trust, Inc.
BENF	Beneficient
CLDT	Chatham Lodging Trust
ARVN	Arvinas, Inc.
HOOD	Robinhood Markets, Inc.
AIJTY	Jianpu Technology Inc.
PLBY	PLBY Group, Inc.
SUNS	Sunrise Realty Trust, Inc.
CCMP	CMC Materials, Inc.
SONX	Sonendo, Inc.
BIPC	Brookfield Infrastructure Corporation
QUISF	Quisitive Technology Solutions, Inc.
AATC	Autoscope Technologies Corporation
XOM	Exxon Mobil Corporation
ADMP	Adamis Pharmaceuticals Corporation
LDSVF	Chocoladefabriken Lindt & Sprüngli AG
BOWL	Bowlero Corp.
DGXX	Digi Power X Inc.
SNPTF	Sunny Optical Technology (Group) Company Limited
RROTF	Roots Corporation
KC	Kingsoft Cloud Holdings Limited
ISNPY	Intesa Sanpaolo S.p.A.
KLTR	Kaltura, Inc.
CWQXF	Castellum AB (publ)
JKS	JinkoSolar Holding Co., Ltd.
601398.SS	Industrial & Commercial Bank of China Ltd.
BABYF	Else Nutrition Holdings Inc.
XJNGF	Xinjiang Goldwind Science & Technology Co., Ltd.
EDU	New Oriental Education & Technology Group Inc.
LMDX	LumiraDx Limited
VNET	VNET Group, Inc.
KPLUY	K+s AG
MDLM	Medley Management Inc.
WT	WisdomTree, Inc.
HCP	HashiCorp, Inc.
AMPH	Amphastar Pharmaceuticals, Inc.
SEEL	Seelos Therapeutics, Inc.
ITJTY	Intrum AB (publ)
RAAS	Cloopen Group Holding Limited
NDVAF	Indiva Limited
OPAD	Offerpad Solutions Inc.
NEWR	New Relic, Inc.
NRDXF	Nordex SE
IVEVF	Inventiva S.A.
GSM	Ferroglobe PLC
LEJUY	Leju Holdings Limited
IMAB	I-Mab
NRDS	NerdWallet, Inc.
SHEN	Shenandoah Telecommunications Company
SIC	Select Interior Concepts, Inc.
CTOS	Custom Truck One Source, Inc.
NTCOY	Natura &Co Holding S.A.
RSG	Republic Services, Inc.
EGAN	eGain Corporation
DOGEF	Ørsted A/S
AVCNF	Avicanna Inc.
RXLSF	Rexel S.A.
SPI	SPI Energy Co., Ltd.
ZYXI	Zynex, Inc.
CSIQ	Canadian Solar Inc.
FCF	First Commonwealth Financial Corporation
GRAM	Gold Flora Corporation
AMBC	Ambac Financial Group, Inc.
AGMH	AGM Group Holdings Inc.
AIH	Aesthetic Medical International Holdings Group Limited
HLTOY	Hellenic Telecommunications Organization S.A.
601857.SS	PetroChina Company Limited
STVN	Stevanato Group S.p.A.
HALO	Halozyme Therapeutics, Inc.
EXC	Exelon Corporation
MNARF	Morguard North American Residential Real Estate Investment Trust
SOIEF	Stolt-Nielsen Limited
WTI	W&T Offshore, Inc.
IX	ORIX Corporation
AM	Antero Midstream Corporation
GENT	Genter Capital Taxable Quality Intermediate ETF
NEXOF	NEXON Co., Ltd.
BZH	Beazer Homes USA, Inc.
PAVM	PAVmed Inc.
MO	Altria Group, Inc.
GNW	Genworth Financial, Inc.
THLPF	Thule Group AB (publ)
CNTY	Century Casinos, Inc.
IPGP	IPG Photonics Corporation
SOGP	Sound Group Inc.
POSAF	POSaBIT Systems Corporation
KDDIF	KDDI Corporation
DLO	DLocal Limited
RCDTF	Recordati Industria Chimica e Farmaceutica S.p.A.
QTTOY	Qutoutiao Inc.
OZON	Ozon Holdings PLC
DRPRY	Dr. Ing. h.c. F. Porsche AG
TPG	TPG Inc.
CLVLY	Clinuvel Pharmaceuticals Limited
LUCD	Lucid Diagnostics Inc.
PBF	PBF Energy Inc.
NTP	Nam Tai Property Inc.
WHWK	Whitehawk Therapeutics Inc
BRDG	Bridge Investment Group Holdings Inc.
RTMAF	Reitmans (Canada) Limited
SSL	Sasol Limited
UMGNF	Universal Music Group N.V.
CTV	Innovid Corp.
OM	Outset Medical, Inc.
EOLS	Evolus, Inc.
MOBL	MobileIron, Inc.
ISSC	Innovative Solutions and Support, Inc.
UL	Unilever PLC
ARGX	argenx SE
OCPNY	Olympus Corporation
QNRX	Quoin Pharmaceuticals, Ltd.
VWAPY	Volkswagen AG
TMHC	Taylor Morrison Home Corporation
LCI	Lannett Company, Inc.
REFI	Chicago Atlantic Real Estate Finance, Inc.
KPTI	Karyopharm Therapeutics Inc.
YOU	Clear Secure, Inc.
ANDE	The Andersons, Inc.
CRGY	Crescent Energy Company
SNDVF	Scandinavian Tobacco Group A/S
INM	InMed Pharmaceuticals Inc.
DBSDF	DBS Group Holdings Ltd
SNVVF	STEP Energy Services Ltd.
BRCC	BRC Inc.
URG	Ur-Energy Inc.
GBOX	GreenBox POS
DHX	DHI Group, Inc.
SOGO	Sogou Inc.
SOPH	SOPHiA GENETICS S.A.
POWW	AMMO, Inc.
FFWM	First Foundation Inc.
ELMSQ	Electric Last Mile Solutions, Inc.
ORI	Old Republic International Corporation
CHA	Chagee Holdings Limited American Depositary Shares
INDI	indie Semiconductor, Inc.
WCC	WESCO International, Inc.
HRC	Hill-Rom Holdings, Inc.
WD	Walker & Dunlop, Inc.
DTE	DTE Energy Company
MITSY	Mitsui & Co., Ltd.
NBY	NovaBay Pharmaceuticals, Inc.
SYRE	Spyre Therapeutics, Inc.
SOR	Source Capital, Inc.
DSX	Diana Shipping Inc.
TNP	Tsakos Energy Navigation Limited
ADRNY	Koninklijke Ahold Delhaize N.V.
ZIP	ZipRecruiter, Inc.
LDOS	Leidos Holdings, Inc.
HAFN	Hafnia Limited
SYN	Synthetic Biologics, Inc.
NRGV	Energy Vault Holdings, Inc.
SSLLF	Siltronic AG
GENI	Genius Sports Limited
PSQH	PSQ Holdings, Inc.
TMCI	Treace Medical Concepts, Inc.
CDLR	Cadeler A/S
GTHX	G1 Therapeutics, Inc.
FWONK	Formula One Group
ACRE	Ares Commercial Real Estate Corporation
AL	Air Lease Corporation
SLRN	Acelyrin, Inc.
BPY	Brookfield Property Partners L.P.
KNTK	Kinetik Holdings Inc.
CADNF	Cascades Inc.
POWL	Powell Industries, Inc.
LPLA	LPL Financial Holdings Inc.
ASIX	AdvanSix Inc.
BSVN	Bank7 Corp.
HYREQ	HyreCar Inc.
DSGR	Distribution Solutions Group, Inc.
PNXGF	Phoenix Group Holdings plc
ATYR	aTyr Pharma, Inc.
ATUS	Altice USA, Inc.
AKR	Acadia Realty Trust
GIL	Gildan Activewear Inc.
BIP	Brookfield Infrastructure Partners L.P.
SUP	Superior Industries International, Inc.
CPAY	Corpay, Inc.
PFG	Principal Financial Group, Inc.
PG	The Procter & Gamble Company
GPK	Graphic Packaging Holding Company
CFLT	Confluent, Inc.
IVVD	Invivyd, Inc.
AVNS	Avanos Medical, Inc.
PLD	Prologis, Inc.
TNDM	Tandem Diabetes Care, Inc.
FQVLF	First Quantum Minerals Ltd.
LIDR	AEye, Inc.
PGEN	Precigen, Inc.
HCKT	The Hackett Group, Inc.
VMD	Viemed Healthcare, Inc.
XWEL	XWELL, Inc.
AKZOF	Akzo Nobel N.V.
AA	Alcoa Corporation
COLD	Americold Realty Trust, Inc.
AEIS	Advanced Energy Industries, Inc.
GAMB	Gambling.com Group Limited
AEOXF	Aeroports de Paris S.A.
BBSI	Barrett Business Services, Inc.
LOIMF	Loomis AB (publ)
FDP	Fresh Del Monte Produce Inc.
SYAXF	Sayona Mining Limited
LINC	Lincoln Educational Services Corporation
JBFCF	Jollibee Foods Corporation
IO	ION Geophysical Corporation
BALL	Ball Corporation
WULF	TeraWulf Inc.
LPRO	Open Lending Corporation
SEBYF	Seb S.A.
PRBZF	Premium Brands Holdings Corporation
CDRE	Cadre Holdings, Inc.
SPWR	SunPower Corporation
EXR	Extra Space Storage Inc.
NRUC	National Rural Utilities Cooper
LNT	Alliant Energy Corporation
IVT	InvenTrust Properties Corp.
WEAV	Weave Communications, Inc.
PCH	PotlatchDeltic Corporation
ROL	Rollins, Inc.
ECC	Eagle Point Credit Company Inc.
GETY	Getty Images Holdings, Inc.
WOW	WideOpenWest, Inc.
INGM	Ingram Micro Holding Corporation
AWI	Armstrong World Industries, Inc.
NCDL	Nuveen Churchill Direct Lending Corp.
SYNA	Synaptics Incorporated
EAF	GrafTech International Ltd.
RRR	Red Rock Resorts, Inc.
GRND	Grindr Inc.
PBYI	Puma Biotechnology, Inc.
SKYE	Skye Bioscience, Inc.
SAPMF	Saipem S.p.A.
PSMMF	Persimmon Plc
ARVLF	Arrival
GSS	Golden Star Resources Ltd.
LYSDY	Lynas Rare Earths Limited
SYPR	Sypris Solutions, Inc.
KBCSY	KBC Group N.V.
TRUE	TrueCar, Inc.
PWFL	PowerFleet, Inc.
UVV	Universal Corporation
ATNI	ATN International, Inc.
CLBS	Caladrius Biosciences, Inc.
NATR	Nature's Sunshine Products, Inc.
XNCR	Xencor, Inc.
AMRX	Amneal Pharmaceuticals, Inc.
BEAT	HeartBeam, Inc.
WDOFF	Wesdome Gold Mines Ltd.
FN	Fabrinet
BLCT	BlueCity Holdings Limited
KBH	KB Home
PKG	Packaging Corporation of America
TLN	Talen Energy Corporation
GD	General Dynamics Corporation
VRTS	Virtus Investment Partners, Inc.
ARBKF	Argo Blockchain plc
MEOH	Methanex Corporation
PKST	Peakstone Realty Trust
ELEEF	Element Fleet Management Corp.
SMC	Summit Midstream Corp.
RDDT	Reddit, Inc.
NA	Nano Labs Ltd
ENSG	The Ensign Group, Inc.
ELAN	Elanco Animal Health Incorporated
IGMS	IGM Biosciences, Inc.
ALTM	Arcadium Lithium plc
ENB	Enbridge Inc.
FSLR	First Solar, Inc.
SPNS	Sapiens International Corporation N.V.
DCFCQ	Tritium DCFC Limited
KPLT	Katapult Holdings, Inc.
AAVVF	Advantage Energy Ltd.
CPXWF	Capital Power Corporation
INMB	INmune Bio, Inc.
CFPUF	Canfor Pulp Products Inc.
SNCAF	SNC-Lavalin Group Inc.
AVPT	AvePoint, Inc.
FSRNQ	Fisker Inc.
IKT	Inhibikase Therapeutics, Inc.
FOXF	Fox Factory Holding Corp.
WSPOF	WSP Global Inc.
PEYE	Precision Optics Corporation, Inc.
INCR	InterCure Ltd.
REAL	The RealReal, Inc.
AMAL	Amalgamated Financial Corp.
ACRFF	Accor S.A.
RBSFY	Rubis
ENTR	ERShares Entrepreneur ETF
LGL	The LGL Group, Inc.
ENVX	Enovix Corporation
ANTE	AirNet Technology Inc.
UFCS	United Fire Group, Inc.
APTX	Aptinyx Inc.
MTCH	Match Group, Inc.
CAMT	Camtek Ltd.
AHEXY	Adecco Group AG
CDUAF	Canadian Utilities Limited
MEC	Mayville Engineering Company, Inc.
PSA	Public Storage
WTBCF	Whitbread plc
DCCPF	DCC plc
LOCO	El Pollo Loco Holdings, Inc.
CAHPF	Evolution Mining Limited
ARPO	Aerpio Pharmaceuticals, Inc.
WWD	Woodward, Inc.
DGHI	Digihost Technology Inc.
BOWFF	Boardwalk Real Estate Investment Trust
OTCM	OTC Markets Group Inc.
BOLSY	B3 S.A. - Brasil, Bolsa, Balcão
GJNSF	Gjensidige Forsikring ASA
JBAXY	Julius Bär Gruppe AG
EVOL	Symbolic Logic, Inc.
ASTS	AST SpaceMobile, Inc.
FMC	FMC Corporation
ARCO	Arcos Dorados Holdings Inc.
SKYW	SkyWest, Inc.
AKA	a.k.a. Brands Holding Corp.
NUWE	Nuwellis, Inc.
TVPKF	Travis Perkins plc
CHPT	ChargePoint Holdings, Inc.
SCPH	scPharmaceuticals Inc.
ALVO	Alvotech
BFLY	Butterfly Network, Inc.
PEB	Pebblebrook Hotel Trust
EURN	Euronav N.V.
SITM	SiTime Corporation
VNE	Veoneer, Inc.
TW	Tradeweb Markets Inc.
UPWK	Upwork Inc.
AZTA	Azenta, Inc.
SAPLF	Sylvania Platinum Limited
PAHC	Phibro Animal Health Corporation
YAHOF	LY Corporation
TLK	Perusahaan Perseroan (Persero) PT Telekomunikasi Indonesia Tbk
ANIK	Anika Therapeutics, Inc.
FREE	Whole Earth Brands, Inc.
ENDP	Endo International plc
GOLD	Barrick Gold Corporation
DOUG	Douglas Elliman Inc.
BLK	BlackRock, Inc.
CSV	Carriage Services, Inc.
TKNO	Alpha Teknova, Inc.
AMPY	Amplify Energy Corp.
FSM	Fortuna Silver Mines Inc.
TECK	Teck Resources Limited
YUM	Yum! Brands, Inc.
CART	Instacart (Maplebear Inc.)
PCRFY	Panasonic Holdings Corporation
BMWYY	Bayerische Motoren Werke AG
HIG	The Hartford Financial Services Group, Inc.
SHERF	Sherritt International Corporation
AEM	Agnico Eagle Mines Limited
RC	Ready Capital Corporation
MLKN	MillerKnoll, Inc.
VIVEF	Vivendi SE
KNTNF	K92 Mining Inc.
FDS	FactSet Research Systems Inc.
TSQ	Townsquare Media, Inc.
NVRO	Nevro Corp.
KBDC	Kayne Anderson BDC, Inc.
FWRG	First Watch Restaurant Group, Inc.
EDVMF	Endeavour Mining plc
SAFRF	Safran S.A.
ISPR	Ispire Technology Inc.
MICS	The Singing Machine Company, Inc.
ZETA	Zeta Global Holdings Corp.
LFLY	Leafly Holdings, Inc.
LDGYY	Landis+Gyr Group AG
MCHX	Marchex, Inc.
AGI	Alamos Gold Inc.
SBCF	Seacoast Banking Corporation of Florida
SOFI	SoFi Technologies, Inc.
DMTK	DermTech, Inc.
SNBR	Sleep Number Corporation
TRGP	Targa Resources Corp.
LX	LexinFintech Holdings Ltd.
RVYL	Ryvyl Inc.
MCOM	Micromobility.com Inc.
SCPPF	S4 Capital plc
DXF	Eason Technology Limited
TGTX	TG Therapeutics, Inc.
AKLI	Akili, Inc.
CNC	Centene Corporation
OPSSF	Opsens Inc.
NVTS	Navitas Semiconductor Corporation
PAC	Grupo Aeroportuario del Pacífico, S.A.B. de C.V.
KSCP	Knightscope, Inc.
PLCE	The Children's Place, Inc.
EXFO	EXFO Inc.
JBSAY	Jbs S.a.
MAGS	Roundhill Magnificent Seven ETF
EDN	Empresa Distribuidora y Comercializadora Norte Sociedad Anónima
ESNT	Essent Group Ltd.
TWODF	Taylor Wimpey plc
BP	BP p.l.c.
POWI	Power Integrations, Inc.
CYTK	Cytokinetics, Incorporated
STXS	Stereotaxis, Inc.
CRS	Carpenter Technology Corporation
CTTAF	Continental AG
FNLIF	First National Financial Corporation
LUNR	Intuitive Machines, Inc.
RIV	RiverNorth Opportunities Fund, Inc.
TCHBF	Tecan Group AG
PAX	Patria Investments Limited
GLAD	Gladstone Capital Corporation
PINS	Pinterest, Inc.
OSH	Oak Street Health, Inc.
DDOG	Datadog, Inc.
KIN	Kindred Biosciences, Inc.
RLGY	Realogy Holdings Corp.
CPPMF	Copper Mountain Mining Corporation
CENX	Century Aluminum Company
VLRS	Controladora Vuela Compañía de Aviación, S.A.B. de C.V.
IRBT	iRobot Corporation
MARA	Marathon Digital Holdings, Inc.
FIVN	Five9, Inc.
PRKA	Parks! America, Inc.
SBLK	Star Bulk Carriers Corp.
TXG	10x Genomics, Inc.
CPE	Callon Petroleum Company
FRSH	Freshworks Inc.
ALDX	Aldeyra Therapeutics, Inc.
IRCP	IRSA Propiedades Comerciales S.A.
SDHC	Smith Douglas Homes Corp.
QSG	QuantaSing Group Ltd
CNNE	Cannae Holdings, Inc.
CRMD	CorMedix Inc.
WSC	WillScot Holdings Corporation
CDRO	Codere Online Luxembourg, S.A.
REE	REE Automotive Ltd.
SCGLY	Société Générale S.A.
XL	XL Fleet Corp.
BKIMF	Bankinter, S.A.
ATRA	Atara Biotherapeutics, Inc.
ANGI	Angi Inc.
DLMAF	Dollarama Inc.
SIGA	SIGA Technologies, Inc.
LB	LandBridge Company LLC
JBLU	JetBlue Airways Corporation
PAIYY	Aesthetic Medical International Holdings Group Limited
HYMC	Hycroft Mining Holding Corporation
CBRE	CBRE Group, Inc.
CLLS	Cellectis S.A.
DRD	DRDGOLD Limited
VRN	Veren Inc.
CTT	CatchMark Timber Trust, Inc.
KRT	Karat Packaging Inc.
CCLP	CSI Compressco LP
OLO	Olo Inc.
ALVOF	Alvopetro Energy Ltd.
OUT	Outfront Media Inc.
EYESW	Second Sight Medical Products Inc
GUKYF	Gulf Keystone Petroleum Limited
TUP	Tupperware Brands Corporation
CMRX	Chimerix, Inc.
AGTI	Agiliti, Inc.
SBOW	SilverBow Resources, Inc.
MEEC	Midwest Energy Emissions Corp.
NVCN	Neovasc Inc.
SHC	Sotera Health Company
REDU	RISE Education Cayman Ltd
MFGP	Micro Focus International plc
BATRK	Atlanta Braves Holdings, Inc.
DNAY	Codex DNA, Inc.
NEM	Newmont Corporation
TPTX	Turning Point Therapeutics, Inc.
CNCE	Concert Pharmaceuticals, Inc.
NGMS	NeoGames S.A.
LJPC	La Jolla Pharmaceutical Company
ALXN	Alexion Pharmaceuticals, Inc.
GOL	Gol Linhas Aéreas Inteligentes S.A.
WERN	Werner Enterprises, Inc.
SWIR	Sierra Wireless, Inc.
AERI	Aerie Pharmaceuticals, Inc.
CMMB	Chemomab Therapeutics Ltd.
MNRL	Brigham Minerals, Inc.
MRCC	Monroe Capital Corporation
JOBY	Joby Aviation, Inc.
EVFM	Evofem Biosciences, Inc.
SGGEF	The Sage Group plc
RIOCF	RioCan Real Estate Investment Trust
DUOL	Duolingo, Inc.
AAUKF	Anglo American plc
IVAC	Intevac, Inc.
FEYE	Mandiant, Inc.
ORLA	Orla Mining Ltd.
SWC	Stillwater Mining Co.
USX	U.S. Xpress Enterprises, Inc.
MBC	MasterBrand, Inc.
ISIG	Insignia Systems, Inc.
SVRA	Savara Inc.
SES	SES AI Corporation
ARQQ	Arqit Quantum Inc.
MNMD	Mind Medicine (MindMed) Inc.
SERV	Serve Robotics Inc.
KNR.NE	Kontrol Technologies Corp.
LSTR	Landstar System, Inc.
FSTR	L.B. Foster Company
PHAT	Phathom Pharmaceuticals, Inc.
PROF	Profound Medical Corp.
ECX	ECARX Holdings, Inc.
PSHZF	Pershing Square Holdings, Ltd.
FTLF	FitLife Brands, Inc.
CTG	Computer Task Group, Incorporated
MNDO	MIND C.T.I. Ltd
VRTX	Vertex Pharmaceuticals Incorporated
PDYN	Palladyne AI Corp.
SSNC	SS&C Technologies Holdings, Inc.
AMSWA	American Software, Inc.
AXAHF	Axa S.A.
NSFDF	NXT Energy Solutions Inc.
DEFI.NE	DeFi Technologies Inc.
NDRBF	NIBE Industrier AB (publ)
VWDRY	Vestas Wind Systems A/S
AQNU	Algonquin Power & Utilities Corp.
WAY	Waystar Holding Corp.
DTSS	Datasea Inc.
SAF	Saratoga Investment Corp 6.25%
PREKF	PrairieSky Royalty Ltd.
SKYX	SKYX Platforms Corp.
GBOOY	Grupo Financiero Banorte, S.A.B. de C.V.
VTOL	Bristow Group Inc.
CIAFF	Champion Iron Limited
IPGDF	IGO Limited
AAGIY	AIA Group Limited
SILV	SilverCrest Metals Inc.
CLIR	ClearSign Technologies Corporation
TDG	TransDigm Group Incorporated
FFNTF	4Front Ventures Corp.
VGZ	Vista Gold Corp.
TSSI	TSS, Inc.
HMSNF	Hammerson plc
NAUT	Nautilus Biotechnology, Inc.
QUMU	Qumu Corporation
BNTGF	Brenntag SE
PHGUF	Pharming Group N.V.
KNDGF	Kindred Group plc
RAMPF	Polaris Renewable Energy Inc.
MGLUY	Magazine Luiza S.A.
COGZF	Cogstate Limited
ELMUF	Elisa Oyj
OFIX	Orthofix Medical Inc.
FRO	Frontline Ltd.
STJPF	St. James's Place plc
BEKSF	N.V. Bekaert S.A.
SLAB	Silicon Laboratories Inc.
ODFL	Old Dominion Freight Line, Inc.
GLG	TD Holdings, Inc.
APAJF	APA Group
GTYH	GTY Technology Holdings Inc.
CNLPL	The Connecticut Light and Power Company
RHHBY	Roche Holding AG
DLA	Delta Apparel, Inc.
HMLP	Höegh LNG Partners LP
SECYF	Secure Waste Infrastructure Corp.
UCBJF	Ucb S.A.
BCNAF	Barco N.V.
EUXTF	Euronext N.V.
OAMCF	OverActive Media Corp.
RMLRF	Ramelius Resources Limited
ALPN	Alpine Immune Sciences, Inc.
KKPNF	Koninklijke KPN N.V.
ASOMF	ASOS Plc
LPTH	LightPath Technologies, Inc.
MDXH	MDxHealth S.A.
AEGXF	Aecon Group Inc.
RDNT	RadNet, Inc.
PDRDF	Pernod Ricard S.A.
STRN	Stran & Company, Inc.
DRUNF	Dream Unlimited Corp.
CANG	Cango Inc.
EIHDF	Evoke plc
OCSI	Oaktree Strategic Income Corporation
NCR	NCR Corporation
HRUFF	H&R Real Estate Investment Trust
CRGE	Charge Enterprises, Inc.
BPTH	Bio-Path Holdings, Inc.
STRY	Starry Group Holdings, Inc.
ICAD	iCAD, Inc.
CREE	Wolfspeed, Inc.
KLR	Kaleyra, Inc.
SREV	ServiceSource International, Inc.
TCRT	Alaunos Therapeutics, Inc.
ACHV	Achieve Life Sciences, Inc.
GBOOF	Grupo Financiero Banorte, S.A.B. de C.V.
PZN	Pzena Investment Management, Inc.
SSDOY	Shiseido Company, Limited
ESS	Essex Property Trust, Inc.
UE	Urban Edge Properties
KRP	Kimbell Royalty Partners, LP
HCCI	Heritage-Crystal Clean, Inc
SPKE	Spark Energy, Inc.
CHIC	Global X MSCI China Communication Services ETF
WTT	Wireless Telecom Group, Inc.
OPFI	OppFi Inc.
HEOFF	H2O Innovation Inc.
MCARY	Mercari, Inc.
ALIM	Alimera Sciences, Inc.
VITL	Vital Farms, Inc.
OIG	Orbital Infrastructure Group, Inc.
ILPT	Industrial Logistics Properties Trust
CTEK	CynergisTek, Inc.
CERE	Cerevel Therapeutics Holdings, Inc.
SWCH	Switch, Inc.
ICPT	Intercept Pharmaceuticals, Inc.
SYKE	Sykes Enterprises, Incorporated
MDWT	Midwest Holding Inc.
AVCT	American Virtual Cloud Technologies, Inc.
STNG	Scorpio Tankers Inc.
CILJF	China Life Insurance Company Limited
MITC	MeaTech 3D Ltd.
MAXR	Maxar Technologies Inc.
BRLI	Brilliant Acquisition Corporation
SPG	Simon Property Group, Inc.
AEZS	Aeterna Zentaris Inc.
SBRA	Sabra Health Care REIT, Inc.
TRSWF	TransAlta Renewables Inc.
BMRN	BioMarin Pharmaceutical Inc.
601988.SS	Bank of China Limited
MIME	Mimecast Limited
FORG	ForgeRock, Inc.
KLG	WK Kellogg Co
FFLWF	Fire & Flower Holdings Corp.
IONQ	IonQ, Inc.
CTRRF	CT Real Estate Investment Trust
MRVFF	Nuvo Pharmaceuticals Inc.
STRC	Sarcos Technology and Robotics Corporation
ATDRY	Auto Trader Group plc
SGI	Somnigroup International Inc
NS	NuStar Energy L.P.
AEL	American Equity Investment Life Holding Company
AGIL	AgileThought, Inc.
NCMGF	Newcrest Mining Limited
NEPT	Neptune Wellness Solutions Inc.
MNKD	MannKind Corporation
MDNA	Medicenna Therapeutics Corp.
SITC	SITE Centers Corp.
PL	Planet Labs PBC
BSQR	BSQUARE Corporation
BBAI	BigBear.ai Holdings, Inc.
SYX	Systemax Inc.
NHI	National Health Investors, Inc.
ATC	Atotech Limited
DASH	DoorDash, Inc.
SAXPF	Sampo Oyj
CPAMF	CapitaLand Integrated Commercial Trust
NNN	National Retail Properties, Inc.
LVOX	LiveVox Holdings, Inc.
SOLO	Electrameccanica Vehicles Corp.
BNXAF	Banxa Holdings Inc.
LLNW	Limelight Networks, Inc.
SP	SP Plus Corporation
MRX	Marex Group plc Ordinary Shares
AESI	Atlas Energy Solutions Inc.
MNDT	Mandiant, Inc.
PTRA	Proterra Inc.
DRH	DiamondRock Hospitality Company
CIOXY	Cielo S.A.
VVX	V2X, Inc.
CLNY	Colony Capital, Inc.
VIK	Viking Holdings Ltd
AVB	AvalonBay Communities, Inc.
HBI	Hanesbrands Inc.
MCF	Contango Oil & Gas Company
GIS	General Mills, Inc.
DO	Diamond Offshore Drilling, Inc.
CVNA	Carvana Co.
ZY	Zymergen Inc.
PXD	Pioneer Natural Resources Company
WING	Wingstop Inc.
CLBT	Cellebrite DI Ltd.
AEY	ADDvantage Technologies Group, Inc.
CSTR	CapStar Financial Holdings, Inc.
WORK	Slack Technologies, Inc.
DEC	Diversified Energy Company PLC
UUGRY	United Utilities Group PLC
JOAN	JOANN Inc.
TRTC	Terra Tech Corp.
SPRT	Support.com, Inc.
ECOM	ChannelAdvisor Corporation
ONTX	Onconova Therapeutics, Inc.
CTXS	Citrix Systems, Inc.
BRFH	Barfresh Food Group, Inc.
SRT	Startek, Inc.
MMAT	Meta Materials Inc.
NATI	National Instruments Corporation
FYBR	Frontier Communications Parent, Inc.
DEI	Douglas Emmett, Inc.
RCAT	Red Cat Holdings, Inc.
OPI	Office Properties Income Trust
FLT	FLEETCOR Technologies, Inc.
PLXP	PLx Pharma Inc.
RXO	RXO, Inc.
MANT	ManTech International Corporation
CIH	China Index Holdings Limited
VJET	voxeljet AG
SHCO	Soho House & Co Inc.
TAST	Carrols Restaurant Group, Inc.
BRSP	BrightSpire Capital, Inc.
XEC	Cimarex Energy Co.
COUP	Coupa Software Incorporated
IS	ironSource Ltd.
MDLA	Medallia, Inc.
SOI	Solaris Oilfield Infrastructure, Inc.
ASGTF	Altus Group Limited
MOR	MorphoSys AG
JACK	Jack in the Box Inc.
EDRVF	EDP Renováveis, S.A.
ADTH	AdTheorent Holding Company, Inc.
VOPKF	Koninklijke Vopak N.V.
WFSTF	Western Forest Products Inc.
AMC	AMC Entertainment Holdings, Inc.
LSGOF	Land Securities Group plc
CHEOF	Cochlear Limited
PET	Wag! Group Co.
ACET	Adicet Bio, Inc.
QTGPF	Qt Group Oyj
RKDA	Arcadia Biosciences, Inc.
DSPG	DSP Group, Inc.
AUR	Aurora Innovation, Inc.
MDC	M.D.C. Holdings, Inc.
WEBR	Weber Inc.
CYBE	CyberOptics Corporation
MGPUF	M&G plc
BRKS	Brooks Automation, Inc.
CPWHF	Ceres Power Holdings plc
OIIM	O2Micro International Limited
JBARF	Julius Bär Gruppe AG
VTXPF	Victrex plc
RENT	Rent the Runway, Inc.
RKLY	Rockley Photonics Holdings Limited
NPTN	NeoPhotonics Corporation
ELIAF	Elia Group SA/NV
BSTG	Biostage, Inc.
RNLX	Renalytix Plc
RGRNF	Regis Resources Limited
GGNDF	GN Store Nord A/S
CRWD	CrowdStrike Holdings, Inc.
RESN	Resonant Inc.
BHF	Brighthouse Financial, Inc.
NOVRF	Nova Royalty Corp.
APYRF	Allied Properties Real Estate Investment Trust
OPEN	Opendoor Technologies Inc.
PQG	PQ Group Holdings Inc.
MOSY	MoSys, Inc.
OBLG	Oblong, Inc.
BTCT	BTC Digital Ltd.
STZHF	Stelco Holdings Inc.
ALYA	Alithya Group Inc.
LNDC	Landec Corporation
GRBMF	Grupo Bimbo, S.A.B. de C.V.
VQS	VIQ Solutions Inc.
SRFM	Surf Air Mobility Inc.
DTEAF	DAVIDsTEA Inc.
BMXMF	bioMérieux S.A.
DRIV	Global X Autonomous & Electric Vehicles ETF
CHHHF	CareRx Corporation
EVBG	Everbridge, Inc.
COP	ConocoPhillips
OMF	OneMain Holdings, Inc.
NWG	NatWest Group plc
LSXMA	The Liberty SiriusXM Group
ACST	Acasti Pharma Inc.
CG	The Carlyle Group Inc.
KLC	KinderCare Learning Companies, Inc.
APPH	AppHarvest, Inc.
ICD	Independence Contract Drilling, Inc.
SICRF	SimCorp A/S
AJRD	Aerojet Rocketdyne Holdings, Inc.
PRST	Presto Automation, Inc.
TCDA	Tricida, Inc.
PAFRF	Pan African Resources PLC
VYGR	Voyager Therapeutics, Inc.
LBTYK	Liberty Global plc
MIC	Macquarie Infrastructure Holdings, LLC
AZIHF	Azimut Holding S.p.A.
CBON	VanEck China Bond ETF
ICAGY	International Consolidated Airlines Group S.A.
CRKN	Crown ElectroKinetics Corp.
DENN	Denny's Corporation
WRD	WeRide Inc.
TALO	Talos Energy Inc.
SWIM	Latham Group, Inc.
IRT	Independence Realty Trust, Inc.
SPLK	Splunk Inc.
EFRTF	Nexus Industrial REIT
DQ	Daqo New Energy Corp.
LGF	Lions Gate Entertainment Corp.
PSBD	Palmer Square Capital BDC Inc.
NVMI	Nova Ltd.
VMW	VMware, Inc.
DOOR	Masonite International Corporation
GHL	Greenhill & Co., Inc.
BUR	Burford Capital Limited
VAL	Valaris Limited
MECVF	Mdf Commerce Inc.
CNNEF	Canacol Energy Ltd
SONO	Sonos, Inc.
CBYDF	Corby Spirit and Wine Limited
RBLX	Roblox Corporation
GHLD	Guild Holdings Company
FUV	Arcimoto, Inc.
EARN	Ellington Residential Mortgage REIT
AYX	Alteryx, Inc.
SECO	Secoo Holding Limited
FTCO	Fortitude Gold Corporation
MMNFF	MedMen Enterprises Inc.
IDEV	iShares Core MSCI International Developed Markets ETF
AMK	AssetMark Financial Holdings, Inc.
BKCC	BlackRock Capital Investment Corporation
VRDN	Viridian Therapeutics, Inc.
SJI	South Jersey Industries, Inc.
MGOL	MGO Global Inc. Common Stock
CNHI	CNH Industrial N.V.
CDL	VictoryShares US Large Cap High Div Volatility Wtd ETF
ZPTA	Zapata Computing Holdings Inc. Common Stock
TGAN	Transphorm, Inc.
AVO	Mission Produce, Inc.
BRLXF	Boralex Inc.
ATCO	Atlas Corp.
NOVA	Sunnova Energy International Inc.
NAAS	NaaS Technology Inc.
CUBE	CubeSmart
LMRK	Landmark Infrastructure Partners LP
MAR	Marriott International, Inc.
CBAY	CymaBay Therapeutics, Inc.
LHDX	Lucira Health, Inc.
AVTA	Avantax, Inc.
OXFCF	Velocys plc
DAY	Dayforce Inc
ADMLF	Adriatic Metals PLC
PAZRF	Plaza Retail REIT
BMRPF	B&M European Value Retail S.A.
CSOD	Cornerstone OnDemand, Inc.
MPCMF	Mapletree Pan Asia Commercial Trust
FOCS	Focus Financial Partners Inc.
EGIO	Edgio, Inc.
ALJJ	ALJ Regional Holdings, Inc.
RNWK	RealNetworks, Inc.
STRS	Stratus Properties Inc.
EVTL	Vertical Aerospace Ltd.
SLCA	U.S. Silica Holdings, Inc.
COLFF	Colabor Group Inc.
DTEA	DAVIDsTEA Inc.
GLOP-PA	GasLog Partners LP
ASTR	Astra Space, Inc.
LUCRF	Lucara Diamond Corp.
RLMD	Relmada Therapeutics, Inc.
WWLNF	Worldline S.A.
VITFF	Victoria Gold Corp.
DSKE	Daseke, Inc.
FENC	Fennec Pharmaceuticals Inc.
BKEP	Blueknight Energy Partners, L.P.
GATO	Gatos Silver, Inc.
IIPZF	InterRent Real Estate Investment Trust
REIT	ALPS Active REIT ETF
ANPMF	Andean Precious Metals Corp.
CCI	Crown Castle Inc.
EBKDY	Erste Group Bank AG
RIVN	Rivian Automotive, Inc.
FSP	Franklin Street Properties Corp.
MODN	Model N, Inc.
CDAY	Dayforce Inc.
DLNG	Dynagas LNG Partners LP
ADES	Advanced Emissions Solutions, Inc.
CD	Chindata Group Holdings Limited
OKLO	Oklo Inc.
ODD	Oddity Tech Ltd.
CVA	Covanta Holding Corporation
SDPI	Superior Drilling Products, Inc.
OHI	Omega Healthcare Investors, Inc.
GDP	Goodrich Petroleum Corporation
LOAR	Loar Holdings Inc.
SMED	Sharps Compliance Corp.
TMX	Terminix Global Holdings, Inc.
WBTN	WEBTOON Entertainment Inc. Common stock
GENK	GEN Restaurant Group, Inc.
KSPN	Kaspien Holdings Inc.
FARM	Farmer Bros. Co.
VRM	Vroom, Inc.
XDSL	mPhase Technologies, Inc.
BFH	Bread Financial Holdings, Inc.
CPT	Camden Property Trust
CHRA	Charah Solutions, Inc.
PNM	PNM Resources, Inc.
JNJ	Johnson & Johnson
GRUB	Just Eat Takeaway.com N.V.
ALFFF	Alfa, S. A. B. de C. V.
SIL	Global X Silver Miners ETF
JDSPY	JD Sports Fashion plc
BCEL	Atreca, Inc.
BPMUF	Basilea Pharmaceutica AG
PK	Park Hotels & Resorts Inc.
GTE	Gran Tierra Energy Inc.
DCTH	Delcath Systems, Inc.
TARO	Taro Pharmaceutical Industries Ltd.
CABGY	Carlsberg A/S
EG	Everest Re Group, Ltd.
IBCP	Independent Bank Corporation
RCL	Royal Caribbean Cruises Ltd.
VXTRF	Voxtur Analytics Corp.
VSTS	Vestis Corporation
FUFU	BitFuFu Inc.
HX	Akso Health Group
AZO	AutoZone, Inc.
IIPR	Innovative Industrial Properties, Inc.
SGIOF	Shionogi & Co., Ltd.
TGL	Treasure Global Inc.
GCTS	GCT Semiconductor Holding, Inc.
SAFM	Sanderson Farms, Inc.
STAY	Extended Stay America, Inc.
FSRD	Fast Radius, Inc.
OWL	Blue Owl Capital Inc.
CLSD	Clearside Biomedical, Inc.
EPZM	Epizyme, Inc.
RGTI	Rigetti Computing, Inc.
ASGN	ASGN Incorporated
WTRH	ASAP, Inc.
PHAR	Pharming Group N.V.
RBOT	Vicarious Surgical Inc.
QADA	QAD Inc.
FFIE	Faraday Future Intelligent Electric Inc.
HTA	Healthcare Trust of America, Inc.
CCAP	Crescent Capital BDC, Inc.
PTGX	Protagonist Therapeutics, Inc.
NRDE	Nu Ride Inc.
NTG	Tortoise Midstream Energy Fund, Inc.
CEZYY	CEZ, a. s.
NVVE	Nuvve Holding Corp.
MTOR	Meritor, Inc.
CLOV	Clover Health Investments, Corp.
PNDZF	Pandora A/S
CPTAL	Capitala Finance Corp.
VET	Vermilion Energy Inc.
TEVA	Teva Pharmaceutical Industries Limited
ABL	Abacus Life, Inc.
FFHL	Fuwei Films (Holdings) Co., Ltd.
PSKRF	Protector Forsikring ASA
INVA	Innoviva, Inc.
HCAT	Health Catalyst, Inc.
NEP	NextEra Energy Partners, LP
LIMAF	Linamar Corporation
RUN	Sunrun Inc.
NSCIF	Nanalysis Scientific Corp.
SEED	Origin Agritech Limited
FATH	Fathom Digital Manufacturing Corporation
FLYX	flyExclusive, Inc.
CVI	CVR Energy, Inc.
MFA	MFA Financial, Inc.
AMPS	Altus Power, Inc.
DAVE	Dave Inc.
CSWC	Capital Southwest Corporation
BHR	Braemar Hotels & Resorts Inc.
CIM	Chimera Investment Corporation
FINV	FinVolution Group
UST	ProShares Ultra 7-10 Year Treasury
TKOMY	Tokio Marine Holdings, Inc.
PTE	PolarityTE, Inc.
ARIS	Aris Water Solutions, Inc.
VRAY	ViewRay, Inc.
HLG	Hailiang Education Group Inc.
ROSE	Rose Hill Acquisition Corporation
DOMA	Doma Holdings Inc.
INVH	Invitation Homes Inc.
NWARF	Norwegian Air Shuttle ASA
AIRC	Apartment Income REIT Corp.
ENDPQ	Endo International plc
QYOUF	QYOU Media Inc.
CSR	Centerspace
NGS	Natural Gas Services Group, Inc.
CHIR	Global X MSCI China Real Estate ETF
CFWFF	Calfrac Well Services Ltd.
VIAO	VIA optronics AG
ALSK	Alaska Communications Systems Group, Inc.
BTBIF	BTB Real Estate Investment Trust
MACE	Mace Security International, Inc.
DHT	DHT Holdings, Inc.
EB	Eventbrite, Inc.
ALSSF	Alsea, S.A.B. de C.V.
SRL	Scully Royalty Ltd.
KHRNF	Khiron Life Sciences Corp.
AGRX	Agile Therapeutics, Inc.
NBSE	NeuBase Therapeutics, Inc.
CLRB	Cellectar Biosciences, Inc.
TPTA	Terra Property Trust, Inc. 6.00
WSKEF	WISeKey International Holding AG
DFLI	Dragonfly Energy Holdings Corp.
TRMR	Tremor International Ltd
MVIS	MicroVision, Inc.
TBBB	BBB Foods Inc.
BJRI	BJ's Restaurants, Inc.
SAVE	Spirit Airlines, Inc.
VTMX	Corporación Inmobiliaria Vesta, S.A.B. de C.V.
GRNT	Granite Ridge Resources, Inc
ICG	Intchains Group Limited
EFC	Ellington Financial Inc.
CRTX	Cortexyme, Inc.
NGTF	Nightfood Holdings, Inc.
FPL	First Trust New Opportunities MLP & Energy Fund
ADSE	ADS-TEC Energy PLC
RTLLF	Rational AG
SGHC	Super Group (SGHC) Limited
FAT	FAT Brands Inc.
KERN	Akerna Corp.
GORV	Lazydays Holdings, Inc.
FNHC	FedNat Holding Company
MEDIF	MediPharm Labs Corp.
RBT	Rubicon Technologies, Inc.
GFS	GLOBALFOUNDRIES Inc.
SYAAF	Syrah Resources Limited
MNY	MoneyHero Limited Class A Ordinary Shares
HRMY	Harmony Biosciences Holdings, Inc.
SMTI	Sanara MedTech Inc.
VG	Venture Global, Inc.
FBRT	Franklin BSP Realty Trust, Inc.
GHI	Greystone Housing Impact Investors LP
PTON	Peloton Interactive, Inc.
SKT	Tanger Inc.
FTDR	Frontdoor, Inc.
GBTG	Global Business Travel Group, Inc.
TGS	Transportadora de Gas del Sur S.A.
CBUS	Cibus, Inc.
VCIG	VCI Global Limited
INPX	Inpixon
AERT	Aeries Technology, Inc
SASI	Sigma Labs, Inc.
GP	GreenPower Motor Company Inc.
SOVO	Sovos Brands, Inc.
LUKOY	PJSC Lukoil
GLGI	Greystone Logistics, Inc.
PMNXF	Perseus Mining Limited
SMIZF	Meliá Hotels International, S.A.
PHXM	PHAXIAM Therapeutics S.A.
DWSN	Dawson Geophysical Company
BTEGF	Baytex Energy Corp.
TUWLF	Tullow Oil plc
BBU	Brookfield Business Partners L.P.
ASAP	Waitr Holdings Inc.
AAOI	Applied Optoelectronics, Inc.
TJX	The TJX Companies, Inc.
STR	Sitio Royalties Corp.
ZFOX	ZeroFox Holdings, Inc.
ADVM	Adverum Biotechnologies, Inc.
ASND	Ascendis Pharma A/S
ORBC	ORBCOMM Inc.
LIFE	aTyr Pharma, Inc.
STIX	Semantix, Inc.
BITF	Bitfarms Ltd.
SND	Smart Sand, Inc.
UNIEF	Uni-Select Inc.
NESRF	Northern Star Resources Limited
HSIC	Henry Schein, Inc.
SHLX	Shell Midstream Partners, L.P.
APLD	Applied Digital Corporation
CMG	Chipotle Mexican Grill, Inc.
PME	Pingtan Marine Enterprise Ltd.
HOLI	Hollysys Automation Technologies Ltd.
INN	Summit Hotel Properties, Inc.
LABFF	Laboratorios Farmaceuticos Rovi, S.A.
LNDNF	Orrön Energy AB (publ)
COIN	Coinbase Global, Inc.
AVDL	Avadel Pharmaceuticals plc
PLAN	Anaplan, Inc.
RFP	Resolute Forest Products Inc.
OMEX	Odyssey Marine Exploration, Inc.
IMMP	Immutep Limited
BSRTF	BSR Real Estate Investment Trust
SB	Safe Bulkers, Inc.
LILM	Lilium N.V.
MAX	MediaAlpha, Inc.
KRRGF	Karora Resources Inc.
PAY	Paymentus Holdings, Inc.
LSCC	Lattice Semiconductor Corporation
WVE	Wave Life Sciences Ltd.
AMOT	Allied Motion Technologies Inc.
NE	Noble Corporation Plc
AUGX	Augmedix, Inc.
SAWLF	Mattr Corp.
M	Macy's, Inc.
CP	Canadian Pacific Railway Limited
HYLN	Hyliion Holdings Corp.
OSG	Overseas Shipholding Group, Inc.
BGS	B&G Foods, Inc.
SWN	Southwestern Energy Company
SCM	Stellus Capital Investment Corporation
FIGS	FIGS, Inc.
NLOK	NortonLifeLock Inc.
GXO	GXO Logistics, Inc.
LL	LL Flooring Holdings, Inc.
HAYW	Hayward Holdings, Inc.
LOOP	Loop Industries, Inc.
AFI	Armstrong Flooring, Inc.
RGLS	Regulus Therapeutics Inc.
HPH	Highest Performances Holdings Inc.
MLEC	Moolec Science S.A.
HTGC	Hercules Capital, Inc.
NVCR	NovoCure Limited
PGTI	PGT Innovations, Inc.
RCMT	RCM Technologies, Inc.
KMDA	Kamada Ltd.
DOCS	Doximity, Inc.
ABOS	Acumen Pharmaceuticals, Inc.
FCPT	Four Corners Property Trust, Inc.
GERN	Geron Corporation
APA	APA Corporation
PEGY	Pineapple Energy Inc.
INVE	Identiv, Inc.
EXFY	Expensify, Inc.
ROP	Roper Technologies, Inc.
JUSHF	Jushi Holdings Inc.
GO	Grocery Outlet Holding Corp.
KRNT	Kornit Digital Ltd.
LSI	Life Storage, Inc.
ALNT	Allient Inc.
PSXP	Phillips 66 Partners LP
LYTS	LSI Industries Inc.
FRLN	Freeline Therapeutics Holdings plc
ALBO	Albireo Pharma, Inc.
LINRF	Liontown Resources Limited
BCSF	Bain Capital Specialty Finance, Inc.
AVNW	Aviat Networks, Inc.
CYTO	Altamira Therapeutics Ltd.
DAIO	Data I/O Corporation
OPRT	Oportun Financial Corporation
SOHU	Sohu.com Limited
OLPX	Olaplex Holdings, Inc.
MBI	MBIA Inc.
SXC	SunCoke Energy, Inc.
CMTOY	Cementos Argos S.A.
FTSI	FTS International, Inc.
TRVI	Trevi Therapeutics, Inc.
EPIX	ESSA Pharma Inc.
UAN	CVR Partners, LP
BSIG	BrightSphere Investment Group Inc.
NLSN	Nielsen Holdings plc
NTBL	Notable Labs, Ltd.
AETUF	ARC Resources Ltd.
PLXS	Plexus Corp.
IMVT	Immunovant, Inc.
VCEL	Vericel Corporation
ITRM	Iterum Therapeutics plc
PPD	PPD, Inc.
GRAMF	TPCO Holding Corp.
ADMS	Adamas Pharmaceuticals, Inc.
MONDF	Mondi plc
SCWO	374Water, Inc.
SNPO	Snap One Holdings Corp.
GEV	GE Vernova Inc.
PCVX	Vaxcyte, Inc.
STI	Solidion Technology Inc.
CMO	Capstead Mortgage Corporation
MPZAF	MIPS AB (publ)
PCT	PureCycle Technologies, Inc.
VANI	Vivani Medical, Inc.
VXRT	Vaxart, Inc.
BLI	Berkeley Lights, Inc.
VTEX	Vtex
TSLA	Tesla, Inc.
TLPH	Talphera, Inc.
ZTO	ZTO Express (Cayman) Inc.
PEPG	PepGen Inc.
OTRK	Ontrak, Inc.
UTHR	United Therapeutics Corporation
GAU	Galiano Gold Inc.
SVM	Silvercorp Metals Inc.
WYY	WidePoint Corporation
PZZA	Papa John's International, Inc.
TLGT	Teligent, Inc.
PCRX	Pacira BioSciences, Inc.
SGA	Saga Communications, Inc.
KGS	Kodiak Gas Services, Inc.
ZYNE	Zynerba Pharmaceuticals, Inc.
OSS	One Stop Systems, Inc.
SAVA	Cassava Sciences, Inc.
ATEYY	Advantest Corporation
BFAGY	Biofrontera AG
LENZ	LENZ Therapeutics, Inc.
HPK	HighPeak Energy, Inc.
ZI	ZoomInfo Technologies Inc.
PEYUF	Peyto Exploration & Development Corp.
IPCFF	International Petroleum Corporation
GNE	Genie Energy Ltd.
NJDCY	Nidec Corporation
MNTS	Momentus Inc.
OSSIF	OneSoft Solutions Inc.
VLVOF	Volvo Car AB (publ.)
CYBN.NE	Cybin Inc.
ORGN	Origin Materials, Inc.
TGB	Taseko Mines Limited
DOC	Healthpeak Properties, Inc.
WEGZY	Weg S.a.
LFDJF	La Française des Jeux S.A.
BLDE	Blade Air Mobility, Inc.
PSB	PS Business Parks, Inc.
ANPC	AnPac Bio-Medical Science Co., Ltd.
HRZN	Horizon Technology Finance Corporation
SAABF	Saab AB (publ)
CPTA	Capitala Finance Corp.
MSON	Misonix, Inc.
QNTFF	Quantafuel ASA
HLNFF	High Liner Foods Incorporated
TRMD	TORM plc
YALA	Yalla Group Limited
CATB	Catabasis Pharmaceuticals, Inc.
KCDMY	Kimberly-Clark de México, S. A. B. de C. V.
HYPR	Hyperfine, Inc.
GREE	Greenidge Generation Holdings Inc.
MGP	MGM Growth Properties LLC
IBDSF	Iberdrola, S.A.
STMRF	Stanmore Resources Limited
ATRWF	Altius Renewable Royalties Corp.
SI	Silvergate Capital Corporation
PULS	PGIM Ultra Short Bond ETF
ERFSF	Eurofins Scientific SE
ACOR	Acorda Therapeutics, Inc.
WOLTF	Wolters Kluwer N.V.
PANL	Pangaea Logistics Solutions, Ltd.
VUZI	Vuzix Corporation
CFPZF	Canfor Corporation
VSTA	Vasta Platform Limited
BDRFF	Beiersdorf AG
ELF	e.l.f. Beauty, Inc.
HMHC	Houghton Mifflin Harcourt Company
TWOU	2U, Inc.
FHS	First High-School Education Group Co., Ltd.
ARCE	Arco Platform Limited
MYPS	PLAYSTUDIOS, Inc.
NEW	Puxin Limited
REV	Revlon, Inc.
ISNS	Autoscope Technologies Corporation
ENR	Energizer Holdings, Inc.
ADCOF	Adcore Inc.
GFAI	Guardforce AI Co., Limited
LBTYA	Liberty Global plc
EAST	Eastside Distilling, Inc.
SLRX	Salarius Pharmaceuticals, Inc.
TSVNF	Everplay Group Plc
ATUSF	Altius Minerals Corporation
ROMJF	Rubicon Organics Inc.
SHLS	Shoals Technologies Group, Inc.
EGTYF	Eguana Technologies Inc.
ACT	Enact Holdings, Inc.
CHB	Global X China Biotech Innovation ETF
CZR	Caesars Entertainment, Inc.
FG	F&G Annuities & Life, Inc.
CDK	CDK Global, Inc.
OYST	Oyster Point Pharma, Inc.
CGEN	Compugen Ltd.
GL	Globe Life Inc.
GWGH	GWG Holdings, Inc.
GSKY	GreenSky, Inc.
TGH	Textainer Group Holdings Limited
HEES	H&E Equipment Services, Inc.
AEHL	Antelope Enterprise Holdings Limited
HTZ	Hertz Global Holdings, Inc.
BVN	Compañía de Minas Buenaventura S.A.A.
AAN	The Aaron's Company, Inc.
XONE	Bondbloxx Bloomberg One Year Target Duration US Treasury ETF
SUNW	Sunworks, Inc.
LIND	Lindblad Expeditions Holdings, Inc.
DCT	Duck Creek Technologies, Inc.
RTP	Reinvent Technology Partners
SSAA	Science Strategic Acquisition Corp. Alpha
ALX	Alexander's, Inc.
BKBEF	Pipestone Energy Corp.
BAND	Bandwidth Inc.
GCT	GigaCloud Technology Inc.
HAIN	The Hain Celestial Group, Inc.
MFIC	MidCap Financial Investment Corporation
SWAG	Stran & Company, Inc.
UWMC	UWM Holdings Corporation
TGONF	Tetragon Financial Group Limited
PHIN	PHINIA Inc.
PUYI	Puyi Inc.
OPYGY	PJSC Polyus
TEDU	TCTM Kids IT Education Inc.
SOND	Sonder Holdings Inc.
LUXH	LuxUrban Hotels Inc.
SBIG	SpringBig Holdings, Inc.
PTR	PetroChina Company Limited
BTM	Bitcoin Depot Inc.
ZVRA	Zevra Therapeutics, Inc.
EBIX	Ebix, Inc.
NFLX	Netflix, Inc.
ZVO	Zovio Inc
VDRFF	Vidrala, S.A.
BETR	Better Home & Finance Holding Company
LZAGY	Lonza Group AG
NETE	Net Element, Inc.
KNBE	KnowBe4, Inc.
ROCC	Ranger Oil Corporation
VTS	Vitesse Energy, Inc.
MRLN	Marlin Business Services Corp.
VRNS	Varonis Systems, Inc.
EV	Mast Global Battery Recycling & Production ETF
WLL	Oasis Petroleum Inc
OCN	Ocwen Financial Corporation
ATAX	America First Multifamily Investors, L.P.
AMRB	American River Bankshares
ASXFF	ASX Limited
MDGL	Madrigal Pharmaceuticals, Inc.
ARKR	Ark Restaurants Corp.
PTRRY	Petro Rio S.A.
IREN	Iris Energy Limited
EVRZF	EVRAZ plc
ALAB	Astera Labs, Inc. Common Stock
XMTR	Xometry, Inc.
PYPD	PolyPid Ltd.
CYFRF	Cypherpunk Holdings Inc.
VRS	Verso Corporation
PRPPF	Purplebricks Group plc
CELTF	Centamin plc
TLNE	Talen Energy Corporation
ATCX	Atlas Technical Consultants, Inc.
GRIL	Muscle Maker, Inc.
ORZCF	Orezone Gold Corporation
DETNF	Aker BP ASA
ATH	Athene Holding Ltd.
TGA	TransGlobe Energy Corporation
AGFY	Agrify Corporation
ROT	Rotor Acquisition Corp.
CRMT	America's Car-Mart, Inc.
FBIN	Fortune Brands Innovations, Inc.
CRK	Comstock Resources, Inc.
ARREF	Amerigo Resources Ltd.
VCTR	Victory Capital Holdings, Inc.
JRJC	China Finance Online Co. Limited
AQUA	Evoqua Water Technologies Corp.
STXB	Spirit of Texas Bancshares, Inc.
RADA	RADA Electronic Industries Ltd.
WRE	Elme Communities
SCVL	Shoe Carnival, Inc.
NVEI	Nuvei Corporation
SIX	Six Flags Entertainment Corporation
LOTZ	CarLotz, Inc.
TRMT	Tremont Mortgage Trust
ACC	American Campus Communities, Inc.
XLRN	Acceleron Pharma Inc.
POYYF	Polymetal International plc
PTLO	Portillo's Inc.
RPT	Rithm Property Trust Inc.
RUM	Rumble Inc.
BTI	British American Tobacco p.l.c.
AIV	Apartment Investment and Management Company
LAZY	Lazydays Holdings, Inc.
TRUP	Trupanion, Inc.
LUGDF	Lundin Gold Inc.
POL	Polished.com Inc.
PFE	Pfizer Inc.
TCBX	Third Coast Bancshares, Inc.
FRBK	Republic First Bancorp, Inc.
REAX	The Real Brokerage Inc.
ZVIA	Zevia PBC
DVD	Dover Motorsports, Inc.
CCJ	Cameco Corporation
NRZ	New Residential Investment Corp.
LVWR	LiveWire Group, Inc.
NGD	New Gold Inc.
AIQ	Global X Artificial Intelligence & Technology ETF
GFI	Gold Fields Limited
SEAS	SeaWorld Entertainment, Inc.
AE	Adams Resources & Energy, Inc.
SOLCF	SOL Global Investments Corp.
DCP	DCP Midstream, LP
PLNT	Planet Fitness, Inc.
FGH	FG Group Holdings Inc.
TSC	TriState Capital Holdings, Inc.
CASA	Casa Systems, Inc.
MJDLF	Major Drilling Group International Inc.
CXP	Columbia Property Trust, Inc.
ELBM	Electra Battery Materials Corporation
GORO	Gold Resource Corporation
ACVA	ACV Auctions Inc.
CNK	Cinemark Holdings, Inc.
CTSH	Cognizant Technology Solutions Corporation
CCHWF	Columbia Care Inc.
VER	VEREIT, Inc.
PCTI	PCTEL, Inc.
CLW	Clearwater Paper Corporation
LIVX	LiveXLive Media, Inc.
LZRFY	Localiza Rent a Car S.A.
LORL	Loral Space & Communications Inc.
STTK	Shattuck Labs, Inc.
PGRU	PropertyGuru Limited
SHAK	Shake Shack Inc.
MBNKF	Metro Bank PLC
BREUF	Bridgemarq Real Estate Services Inc.
FRGE	Forge Global Holdings, Inc.
RWBYF	Red White & Bloom Brands Inc.
NP	Neenah, Inc.
RCII	Rent-A-Center, Inc.
ROLL	RBC Bearings Incorporated
BTG	B2Gold Corp.
OTIVF	On Track Innovations Ltd.
AMOV	América Móvil, S.A.B. de C.V.
SEZL	Sezzle Inc.
DISH	DISH Network Corporation
CBB	Cincinnati Bell Inc.
SSB	SouthState Corporation
PFPT	Proofpoint, Inc.
SCA	Stellus Capital Investment Corporation 5.75% NT 2022
SLGG	Super League Enterprise, Inc.
SGIOY	Shionogi & Co., Ltd.
SDIG	Stronghold Digital Mining, Inc.
ABST	Absolute Software Corporation
PTNR	Partner Communications Company Ltd.
AWAY	Amplify Travel Tech ETF
PBIO	Pressure BioSciences, Inc.
ABTX	Allegiance Bancshares, Inc.
YNDX	Yandex N.V.
MRPRF	MERLIN Properties SOCIMI, S.A.
SRLP	Sprague Resources LP
BILI	Bilibili Inc.
CSA	VictoryShares US Small Cap Volatility Wtd ETF
XROLF	Xero Limited
BNFT	Benefitfocus, Inc.
ANZBY	Australia and New Zealand Banking Group Limited
SFET	Safe-T Group Ltd.
CLNC	Colony Credit Real Estate, Inc.
SLDP	Solid Power, Inc.
SCU	Sculptor Capital Management, Inc.
EGRX	Eagle Pharmaceuticals, Inc.
FLMN	Falcon Minerals Corporation
PTALF	PetroTal Corp.
SBRCY	Sberbank of Russia
LINX	Linx S.A.
VWE	Vintage Wine Estates, Inc.
DECPF	Diversified Energy Company PLC
PAYA	Paya Holdings Inc.
FAZE	FaZe Holdings Inc.
RIDE	Lordstown Motors Corp.
MRAI	Marpai, Inc.
MCG	Membership Collective Group Inc.
MXIM	Maxim Integrated Products, Inc.
RE	Everest Re Group, Ltd.
TRTN	Triton International Limited
FUBO	fuboTV Inc.
JP	Jupai Holdings Limited
TWTR	Twitter, Inc. (delisted)
FLDR	Fidelity Low Duration Bond Factor ETF
BATRA	Atlanta Braves Holdings, Inc.
AMFPF	Amplifon S.p.A.
NAT	Nordic American Tankers Limited
ATSAF	ATS Corporation
ID	PARTS iD, Inc.
CTK	CooTek (Cayman) Inc.
XENT	Intersect ENT, Inc.
ABB	ABB Ltd
SLRC	SLR Investment Corp.
ALK	Alaska Air Group, Inc.
MDP	Meredith Corporation
GNL	Global Net Lease, Inc.
MTAL	MAC Copper Ltd
PKI	PerkinElmer, Inc.
LPI	Laredo Petroleum, Inc.
PCOM	Points.com Inc.
HLBZ	Helbiz, Inc.
VTLE	Vital Energy, Inc.
PNST	Pinstripes Holdings Inc.
UP	Wheels Up Experience Inc.
BODY	The Beachbody Company, Inc.
XM	Qualtrics International Inc.
TSRYY	Treasury Wine Estates Limited
FBC	Flagstar Bancorp, Inc.
BBTVF	BBTV Holdings Inc.
ZIXI	Zix Corporation
INS	CoreCard Corporation
EVTV	Envirotech Vehicles, Inc.
WPG	Washington Prime Group Inc.
WEJO	Wejo Group Limited
QTEK	QualTek Services Inc.
SOBKY	SoftBank Corp.
EFLVF	Electrovaya Inc.
USWS	U.S. Well Services, Inc.
LNTH	Lantheus Holdings, Inc.
FLTDF	Flow Traders N.V.
MNOD.IL	PJSC Mining and Metallurgical Company Norilsk Nickel
FRMO	FRMO Corporation
COG	Cabot Oil & Gas Corporation
PDCE	PDC Energy, Inc.
RYB	RYB Education, Inc.
ARD	Ardagh Group S.A.
AQMS	Aqua Metals, Inc.
PBPB	Potbelly Corporation
CPLP	Capital Product Partners L.P.
PRPL	Purple Innovation, Inc.
DREUF	Dream Industrial Real Estate Investment Trust
EP	Empire Petroleum Corporation
CLR	Continental Resources, Inc.
NWINF	Naked Wines plc
PING	Ping Identity Holding Corp.
ITMR	Itamar Medical Ltd.
ITCB	Itaú Corpbanca
DLVHF	Delivery Hero SE
AUTO	AutoWeb, Inc.
ZEN	Zendesk, Inc.
EVEX	Eve Holding, Inc.
OZMLF	OZ Minerals Limited
BCOR	Grayscale Bitcoin Adopters ETF
AVYA	Avaya Holdings Corp.
RRD	R. R. Donnelley & Sons Company
PBCT	People's United Financial, Inc.
HYRE	HyreCar Inc.
BPFH	Boston Private Financial Holdings, Inc.
IAA	IAA, Inc.
GCP	GCP Applied Technologies Inc.
FMBI	First Midwest Bancorp, Inc.
ARBE	Arbe Robotics Ltd.
PROG	Biora Therapeutics, Inc.
VEC	V2X, Inc.
CHMA	Chiasma, Inc.
IDW	IDW Media Holdings, Inc.
TRIB	Trinity Biotech plc
AMBP	Ardagh Metal Packaging S.A.
TUEM	Tuesday Morning Corporation
ACER	Acer Therapeutics Inc.
SALRF	SalMar ASA
VNTR	Venator Materials PLC
FLNCF	Freelancer Limited
SANW	S&W Seed Company
HNST	The Honest Company, Inc.
INVVY	Indivior PLC
BHG	Bright Health Group, Inc.
SKYS	Sky Solar Holdings, Ltd.
MGLN	Magellan Health, Inc.
SRNA	CEA Industries Inc.
OBNK	Origin Bancorp, Inc.
ZGNX	Zogenix, Inc.
SUMO	Sumo Logic, Inc.
VVNT	Vivint Smart Home, Inc.
ISR	Isoray, Inc.
STAR	iStar Inc.
CBLI	Cytocom, Inc.
TGODF	The Green Organic Dutchman Holdings Ltd.
ENIA	Enel Américas S.A.
OXLC	Oxford Lane Capital Corp.
MTBC	CareCloud, Inc.
SBBP	Strongbridge Biopharma plc
GRA	W. R. Grace & Co.
BRT	BRT Apartments Corp.
SSU	SIGNA Sports United N.V.
STLFF	Stillfront Group AB (publ)
VECT	VectivBio Holding AG
CROMF	Crombie Real Estate Investment Trust
NXTD	Nxt-ID, Inc.
WWR	Westwater Resources, Inc.
SKWD	Skyward Specialty Insurance Group, Inc.
ELMS	Electric Last Mile Solutions, Inc.
UPH	UpHealth, Inc.
ARGO	Argo Group International Holdings, Ltd.
LLYVK	Liberty Live Group
ONEM	1Life Healthcare, Inc.
AINV	Apollo Investment Corporation
OTIC	Otonomy, Inc.
BAER	Bridger Aerospace Group Holdings, Inc. Common Stock
TREC	Trecora Resources
LBPH	Longboard Pharmaceuticals, Inc.
AFIN	American Finance Trust, Inc.
CXDC	China XD Plastics Company Limited
AMRS	Amyris, Inc.
PEAR	Pear Therapeutics, Inc.
CHNG	Change Healthcare Inc.
AGLE	Aeglea BioTherapeutics, Inc.
ONE	Meta Data Limited
JT	Jianpu Technology Inc.
PGY	Pagaya Technologies Ltd.
FCXXF	First Capital Real Estate Investment Trust
WRI	Weingarten Realty Investors
CURO	CURO Group Holdings Corp.
SUNL	Sunlight Financial Holdings Inc.
RTL	The Necessity Retail REIT, Inc.
BSHVF	Bushveld Minerals Limited
LOV	Spark Networks SE
FOE	Ferro Corporation
LIZI	Lizhi Inc.
JE	Just Energy Group Inc.
MILE	Metromile, Inc.
TBLA	Taboola.com Ltd.
OTMO	Otonomo Technologies Ltd.
ADS	Bread Financial Holdings, Inc.
EAR	Eargo, Inc.
KMMPF	Killam Apartment REIT
ORCC	Owl Rock Capital Corporation
QTT	Qutoutiao Inc.
APR	Apria, Inc.
FSKR	FS KKR Capital Corp. II
ATRS	Antares Pharma, Inc.
RAD	Rite Aid Corporation
METX	Meten Holding Group Ltd.
SUMR	Summer Infant, Inc.
GBS	GBS Inc.
JOBS	51job, Inc.
IMBI	iMedia Brands, Inc.
HHR	HeadHunter Group PLC
VIVO	Meridian Bioscience, Inc.
NVTA	Invitae Corporation
DROOF	Deliveroo plc
EIC	Eagle Point Income Company Inc.
FRG	Franchise Group, Inc.
CVET	Covetrus, Inc.
VRTV	Veritiv Corporation
OCDX	Ortho Clinical Diagnostics Holdings plc
LQSIF	Alcanna Inc.
APRN	Blue Apron Holdings, Inc.
CVRX	CVRx, Inc.
MXDHF	MDxHealth S.A.
SIEN	Sientra, Inc.
CYXT	Cyxtera Technologies, Inc.
GROV	Grove Collaborative Holdings, Inc.
BBL	BHP Group Limited
HBP	Huttig Building Products, Inc.
FPACX	FPA Crescent Fund
NLCP	NewLake Capital Partners, Inc.
NLS	Nautilus, Inc.
NOVN	Novan, Inc.
CRXTQ	Clarus Therapeutics Holdings, Inc.
HRVSF	Harvest Health & Recreation Inc.
MSGN	MSG Networks Inc.
QUOT	Quotient Technology Inc.
NUVA	NuVasive, Inc.
CTIC	CTI BioPharma Corp.
HOME	At Home Group Inc.
CSPR	Casper Sleep Inc.
SNY	Sanofi
NYC	American Strategic Investment Co.
CORR	CorEnergy Infrastructure Trust, Inc.
AFIB	Acutus Medical, Inc.
LYLT	Loyalty Ventures Inc.
EYES	Second Sight Medical Products, Inc.
TALK	Talkspace, Inc.
SRC	Spirit Realty Capital, Inc.
HCDI	Harbor Custom Development, Inc.
STFC	State Auto Financial Corporation
SGOC	SGOCO Group, Ltd.
TLTFF	Theralase Technologies Inc.
MACK	Merrimack Pharmaceuticals, Inc.
MDCA	MDC Partners Inc.
OBLN	Obalon Therapeutics, Inc.
FTCH	Farfetch Limited
ESXB	Community Bankers Trust Corporation
TDUP	ThredUp Inc.
HMPT	Home Point Capital Inc.
LPG	Dorian LPG Ltd.
AVLR	Avalara, Inc.
CZOO	Cazoo Group Ltd
FRC	First Republic Bank
SAIL	SailPoint, Inc.
OFC	Corporate Office Properties Trust
TPCO	Tribune Publishing Company
BRDS	Bird Global, Inc.
ALTA	Altabancorp
BMTC	Bryn Mawr Bank Corporation
APTS	Preferred Apartment Communities, Inc.
MTL	Mechel PAO
PEI	Pennsylvania Real Estate Investment Trust
BPMP	BP Midstream Partners LP
RMED	Ra Medical Systems, Inc.
WMC	Western Asset Mortgage Capital Corporation
STSA	Satsuma Pharmaceuticals, Inc.
NUAN	Nuance Communications, Inc.
CEQP	Crestwood Equity Partners LP
SOLY	Soliton, Inc.
DMS	Digital Media Solutions, Inc.
LUMO	Lumos Pharma, Inc.
AAIC	Arlington Asset Investment Corp.
DSSI	Diamond S Shipping Inc.
FOBIF	Fobi AI Inc.
CLVS	Clovis Oncology, Inc.
STRW	Strawberry Fields REIT LLC
FRTA	Forterra, Inc.
FBHS	Fortune Brands Home & Security, Inc.
USAK	USA Truck, Inc.
MF	Missfresh Limited
DISCK	Warner Bros. Discovery, Inc.
REUN	Reunion Neuroscience Inc.
GLS	Gelesis Holdings, Inc.
CHS	Chico's FAS, Inc.
AVEVF	AVEVA Group plc
ORTX	Orchard Therapeutics plc
HIBB	Hibbett, Inc.
EXPR	Express, Inc.
CS	Credit Suisse Group AG
ZEAL	Zealand Pharma A/S
JAX	J. Alexander's Holdings, Inc.
ROVR	Rover Group, Inc.
HSKA	Heska Corporation
AVID	Avid Technology, Inc.
PRXXF	Paradox Interactive AB (publ)
RVLP	RVL Pharmaceuticals plc
SPPI	Spectrum Pharmaceuticals, Inc.
CTTPY	CTT - Correios De Portugal, S.A.
AUSAF	Australis Capital Inc.
WISH	ContextLogic Inc.
HT	Hersha Hospitality Trust
XSPA	XpresSpa Group, Inc.
QTNT	Quotient Limited
WLTW	Willis Towers Watson Public Limited Company
TRHC	Tabula Rasa HealthCare, Inc.
IDRA	Idera Pharmaceuticals, Inc.
CNVY	Convey Health Solutions Holdings, Inc.
GTS	Triple-S Management Corporation
MSPR	MSP Recovery, Inc.
NXGN	NextGen Healthcare, Inc.
RMRM	Seven Hills Realty Trust
BXRX	Baudax Bio, Inc.
MRTX	Mirati Therapeutics, Inc.
SGFY	Signify Health, Inc.
NBRV	Nabriva Therapeutics plc
ABCM	Abcam plc
DRE	Duke Realty Corporation
SMFR	Sema4 Holdings Corp.
WSTG	Wayside Technology Group, Inc.
ANTM	Elevance Health Inc.
KRTX	Karuna Therapeutics, Inc.
ERYP	ERYTECH Pharma S.A.
GOED	Polished.com Inc.
LMNL	Liminal BioSciences Inc.
CBIO	Catalyst Biosciences, Inc.
FMTX	Forma Therapeutics Holdings, Inc.
NETI	Eneti Inc.
ECIFF	Electricité de France S.A.
AASZF	Atlantic Sapphire ASA
CHCT	Community Healthcare Trust Incorporated
PFIN	P&F Industries, Inc.
CLXT	Calyxt, Inc.
KSU	Kansas City Southern
PRTY	Party City Holdco Inc.
SRGA	Surgalign Holdings, Inc.
SFE	Safeguard Scientifics, Inc.
CVT	Cvent Holding Corp.
GTT	GTT Communications, Inc.
FRGI	Fiesta Restaurant Group, Inc.
BFI	BurgerFi International, Inc.
TTCF	Tattooed Chef, Inc.
CCXI	ChemoCentryx, Inc.
BRCN	Burcon NutraScience Corporation
TLND	Talend S.A.
AUY	Yamana Gold Inc.
QTS	QTS Realty Trust, Inc.
CLSN	Imunon, Inc.
ELEMF	Elemental Altus Royalties Corp.
HZN	Horizon Global Corporation
TUFN	Tufin Software Technologies Ltd.
ELY	Callaway Golf Company
LUB	Luby's, Inc.
IIN	IntriCon Corporation
HMTV	Hemisphere Media Group, Inc.
RUTH	Ruth's Hospitality Group, Inc.
EMBK	Embark Technology, Inc.
RADI	Radius Global Infrastructure, Inc.
ZEV	Lightning eMotors, Inc.
MMAC	MMA Capital Holdings, Inc.
CANO	Cano Health, Inc.
CNXT	VanEck ChiNext ETF
RMO	Romeo Power, Inc.
NEX	NexTier Oilfield Solutions Inc.
DDAIF	Mercedes-Benz Group AG
OBSV	ObsEva S.A.
TESS	TESSCO Technologies Incorporated
IVC	Invacare Corporation
POLY	Plantronics, Inc.
VORB	Virgin Orbit Holdings, Inc.
LFG	Archaea Energy Inc.
BGRY	Berkshire Grey, Inc.
FTRP	Field Trip Health Ltd.
CRXT	Clarus Therapeutics Holdings, Inc.
HSC	Harsco Corporation
MPZZF	MPC Container Ships ASA
NLTX	Neoleukin Therapeutics, Inc.
CBL	CBL & Associates Properties, Inc.
POSH	Poshmark, Inc.
BBI	Brickell Biotech, Inc.
VYNT	Vyant Bio, Inc.
WKME	WalkMe Ltd.
PRTK	Paratek Pharmaceuticals, Inc.
CNST	Constellation Pharmaceuticals, Inc.
ECHO	Echo Global Logistics, Inc.
SCON	Superconductor Technologies Inc.
CSU	Capital Senior Living Corporation
SELB	Selecta Biosciences, Inc.
LAIX	LAIX Inc.
AVEO	AVEO Pharmaceuticals, Inc.
TCN	Tricon Residential Inc.
GNRS	The Greenrose Holding Company Inc.
SGEN	Seagen Inc.
ATHX	Athersys, Inc.
MYOV	Myovant Sciences Ltd.
ONCS	OncoSec Medical Incorporated
REPH	Recro Pharma, Inc.
HARP	Harpoon Therapeutics, Inc.
ZIOP	ZIOPHARM Oncology, Inc.
MIRO	Miromatrix Medical Inc.
ZSAN	Zosano Pharma Corporation
INFI	Infinity Pharmaceuticals, Inc.
MITO	Stealth BioTherapeutics Corp
EARS	Altamira Therapeutics Ltd.
TYME	Tyme Technologies, Inc.
ASPCF	Acerus Pharmaceuticals Corporation
VLNS	The Valens Company Inc.
EMHTF	Emerald Health Therapeutics, Inc.
HHC	The Howard Hughes Corporation
MNTV	Momentive Global Inc.
INDT	INDUS Realty Trust, Inc.
CECE	CECO Environmental Corp.
TBK	Triumph Financial, Inc.
TTBKF	2020 Bulkers Ltd.
NNA	Navios Maritime Acquisition Corporation
GPP	Green Plains Partners LP
GLOP	GasLog Partners LP
ENBL	Enable Midstream Partners, LP
HEP	Holly Energy Partners, L.P.
MMP	Magellan Midstream Partners, L.P.
DEN	Denbury Inc.
OMP	Oasis Midstream Partners LP
HFC	HF Sinclair Corporation
ESTE	Earthstone Energy, Inc.
CDEV	Permian Resources Corporation
AXAS	Abraxas Petroleum Corporation
ENRFF	Enerflex Ltd.
EXTN	Exterran Corporation
WBT	Welbilt, Inc.
RAVN	Raven Industries, Inc.
CNR	Core Natural Resources, Inc.
OEG	Orbital Energy Group, Inc.
SNR	New Senior Investment Group Inc.
BRMK	Broadmark Realty Capital Inc.
DRTT	DIRTT Environmental Solutions Ltd.
HIL	Hill International, Inc.
IEA	Infrastructure and Energy Alternatives, Inc.
AENZ	Aenza S.A.A.